10 15 88 1 2 2 5 108 105 15 15 92 15 1 4 5 89 90 91 15 15 15 15 14 15 15 108 15 15 15 15 15 15 15 15 15 15 15 15 15 15 15 15 15 15 15 15 15 15 15 109 15 15 109 15 15 15 15 15 15 15 15 15 15 15 15 15 15 15 15 15 15 15 15 15 15 15 110 15 15 110 14 25 25 25 25 25 25 25 25 25 14 81 82 83 84 92 88 15 11 
6 61 94 27 27 27 26 116 114 27 60 98 28 58 27 60 95 96 97 27 27 27 27 6 27 28 116 27 27 27 27 27 27 60 27 27 27 27 27 27 27 27 27 27 27 27 27 27 27 27 117 27 27 117 27 27 27 27 27 27 28 27 27 27 27 27 27 27 27 27 27 27 27 27 27 27 27 118 27 27 118 6 0 0 0 0 0 0 0 0 0 6 74 75 76 77 98 94 60 6 
6 28 60 64 65 65 66 60 27 27 27 27 27 27 27 27 27 27 60 27 27 27 27 6 27 27 27 27 27 27 29 27 27 27 27 27 27 27 27 27 28 27 27 27 60 27 27 27 27 27 27 28 27 27 27 27 60 27 27 27 27 27 27 26 27 27 28 27 27 27 27 27 27 60 27 27 27 27 27 28 27 6 0 0 0 0 0 0 0 0 0 6 27 30 27 28 27 27 27 6 
6 27 27 62 27 27 27 27 27 27 27 26 27 27 27 27 63 27 27 27 27 27 27 6 27 27 27 27 28 27 27 28 27 27 27 28 27 27 27 60 27 27 27 28 27 27 27 27 27 29 27 27 26 27 27 27 28 58 27 27 27 27 27 28 27 27 27 27 26 27 27 28 27 27 27 28 27 27 26 27 27 6 0 0 0 0 0 0 0 0 0 6 65 65 65 65 65 66 28 6 
6 27 26 60 27 27 28 27 62 27 53 54 27 27 27 27 67 27 27 27 28 29 27 6 27 27 27 27 27 27 27 27 27 27 27 27 27 27 27 27 27 27 27 27 27 27 27 27 27 27 27 27 27 27 27 27 27 27 27 27 60 27 27 59 27 27 27 27 27 28 27 27 27 27 27 27 27 27 27 27 27 6 0 0 0 0 0 0 0 0 0 6 27 69 27 61 27 60 27 6 
22 25 25 102 47 50 103 25 25 25 25 25 25 25 25 25 11 27 27 27 27 27 27 6 27 27 60 27 27 27 10 15 15 92 15 15 15 106 15 111 112 113 15 109 109 11 60 27 26 27 28 27 10 15 15 109 109 105 27 27 17 15 110 110 14 25 102 47 50 103 25 25 25 25 11 27 27 27 27 27 27 6 0 0 0 0 0 0 0 0 0 6 26 27 27 27 27 27 27 6 
0 0 0 0 0 0 0 0 0 0 0 0 0 0 0 0 6 27 58 27 27 27 27 6 27 27 27 27 27 27 6 62 27 98 28 27 27 115 27 119 27 120 27 117 117 6 27 27 27 29 27 27 6 27 27 117 117 114 27 27 27 27 118 118 6 0 0 0 0 0 0 0 0 0 6 27 27 27 27 60 27 6 0 0 0 0 0 0 0 0 0 6 70 71 70 71 27 27 30 6 
0 0 0 0 0 0 0 0 0 0 0 0 0 0 0 0 6 27 27 27 27 28 27 6 27 27 27 27 27 27 21 28 27 60 27 28 30 27 62 27 27 28 29 26 61 6 27 27 28 27 27 27 6 57 27 27 28 27 27 27 26 27 28 27 6 0 0 0 0 0 0 0 0 0 6 27 27 27 27 27 27 6 0 0 0 0 0 0 0 0 0 6 74 75 74 75 28 27 27 6 
0 0 0 0 0 0 0 0 0 0 0 0 0 0 0 0 6 27 27 27 27 27 27 6 27 27 27 27 27 27 27 27 27 27 27 27 27 27 27 27 26 27 60 27 59 6 27 27 27 27 27 27 6 28 27 53 54 27 27 28 27 27 53 27 6 0 0 0 0 0 0 0 0 0 6 27 28 26 27 27 27 21 0 0 0 0 0 0 0 0 0 6 65 65 65 65 65 66 26 6 
0 0 0 0 0 0 0 0 0 0 0 0 0 0 0 0 6 27 27 27 27 27 27 6 27 27 29 27 27 27 27 61 27 26 27 27 60 27 17 92 92 92 92 93 93 9 27 27 60 60 27 27 6 27 62 27 27 27 27 27 27 27 27 26 6 0 0 0 0 0 0 0 0 0 6 27 27 27 27 27 27 40 0 0 0 0 0 0 0 0 0 6 62 27 27 27 27 60 27 6 
0 0 0 0 0 0 0 0 0 0 0 0 0 0 0 0 6 27 27 29 27 27 27 6 27 27 27 27 60 27 7 26 27 27 27 27 27 27 27 98 98 98 98 99 99 6 27 27 27 27 27 27 6 27 58 51 52 27 27 27 28 57 54 27 6 0 0 0 0 0 0 0 0 0 6 27 27 27 27 27 27 46 0 0 0 0 0 0 0 0 0 6 27 27 26 27 27 27 27 6 
0 0 0 0 0 0 0 0 0 0 0 0 0 0 0 0 6 27 27 28 27 27 58 6 27 28 27 27 27 27 6 27 27 29 27 62 27 27 27 26 27 27 28 62 27 6 27 27 27 27 27 27 6 28 27 55 56 27 26 27 27 27 27 56 6 0 0 0 0 0 0 0 0 0 6 27 27 60 27 28 27 7 0 0 0 0 0 0 0 0 0 6 27 27 27 27 27 26 27 6 
0 0 0 0 0 0 0 0 0 0 0 0 0 0 0 0 6 27 27 27 27 28 27 21 27 27 27 27 27 27 6 27 60 27 28 27 60 27 27 27 29 27 60 70 71 6 27 27 27 27 28 27 6 27 27 26 27 27 28 53 27 27 26 27 6 0 0 0 0 0 0 0 0 0 6 27 27 27 27 27 27 6 0 0 0 0 0 0 0 0 0 6 26 27 60 27 27 60 62 6 
0 0 0 0 0 0 0 0 0 0 0 0 0 0 0 0 6 27 62 27 27 27 27 27 27 27 27 28 27 27 6 27 61 27 26 27 27 58 28 61 27 26 27 74 75 6 27 26 27 27 27 27 6 53 28 27 58 27 27 62 62 59 27 28 6 0 0 0 0 0 0 0 0 0 6 27 27 27 26 27 27 18 15 15 15 15 15 15 15 15 15 20 15 15 16 27 27 17 15 9 
0 0 0 0 0 0 0 0 0 0 0 0 0 0 0 0 6 27 27 27 27 27 27 27 27 27 27 27 27 27 8 25 25 25 25 25 25 25 25 25 25 25 25 25 25 9 27 27 27 60 27 27 18 15 15 15 15 108 15 15 11 27 27 62 6 0 0 0 0 0 0 0 0 0 6 27 27 27 27 27 27 27 27 27 27 27 27 27 27 27 27 27 27 27 27 27 27 27 27 6 
0 0 0 0 0 0 0 0 0 0 0 0 0 0 0 0 6 27 27 60 27 27 27 7 27 27 27 27 27 27 6 0 0 0 0 0 0 0 0 0 0 0 0 0 0 6 27 27 27 27 27 27 27 27 27 27 27 116 27 27 6 28 53 54 6 0 0 0 0 0 0 0 0 0 6 27 27 28 27 27 27 27 27 29 27 27 27 60 27 27 27 28 27 60 64 65 65 66 60 6 
0 0 0 0 0 0 0 0 0 0 0 0 0 0 0 0 6 27 27 27 27 28 27 6 27 28 27 60 28 27 6 0 0 0 0 0 0 0 0 0 0 0 0 0 0 6 27 27 29 27 27 27 27 27 27 27 26 27 28 27 8 25 25 25 23 0 0 0 0 0 0 0 0 0 6 27 27 27 27 27 60 27 27 27 27 26 27 27 27 27 27 27 28 27 27 27 27 27 27 6 
0 0 0 0 0 0 0 0 0 0 0 0 0 0 0 0 6 27 27 27 27 27 62 6 27 27 27 27 27 27 21 0 0 0 0 0 0 0 0 0 0 0 0 0 0 6 27 27 27 27 27 28 27 27 60 27 27 29 27 27 6 0 0 0 0 0 0 0 0 0 0 0 0 0 6 27 27 27 27 27 27 27 27 27 27 27 27 28 27 27 27 27 27 27 27 27 27 27 27 6 
0 0 0 0 0 0 0 0 0 0 0 0 0 0 0 0 21 27 27 27 27 27 27 6 27 27 27 27 27 58 40 0 0 0 0 0 0 0 0 0 0 0 0 0 0 6 27 28 27 27 27 27 27 27 27 27 27 27 27 27 6 0 0 0 0 0 0 0 0 0 0 0 0 0 8 15 15 15 15 105 15 108 15 15 15 15 16 27 27 17 15 15 15 15 15 15 15 15 15 9 
0 0 0 0 0 0 0 0 0 0 0 0 0 0 0 0 35 27 27 27 28 27 27 6 27 60 27 27 27 27 46 0 0 0 0 0 0 0 0 0 0 0 0 0 0 22 14 15 15 15 15 15 15 15 15 16 27 27 27 28 18 15 15 15 15 15 15 15 15 15 15 15 15 15 19 27 27 27 27 114 27 116 27 27 27 27 27 27 27 27 27 27 27 27 27 27 27 27 27 6 
0 0 0 0 0 0 0 0 0 0 0 0 0 0 0 0 45 27 27 27 27 27 27 6 27 27 27 27 28 27 6 0 0 0 0 0 0 0 0 0 0 0 0 0 0 0 6 27 27 27 27 27 27 27 27 27 27 27 27 27 27 27 27 27 27 27 27 27 27 27 27 27 27 27 27 27 28 29 27 27 27 27 27 28 27 27 27 27 27 29 28 27 26 27 27 27 29 28 27 6 
0 0 0 0 0 0 0 0 0 0 0 0 0 0 0 0 7 27 27 27 27 27 27 18 15 15 111 112 113 15 20 15 15 15 0 0 0 0 0 0 0 0 0 0 0 0 6 27 27 28 27 27 27 27 27 28 27 27 27 27 26 27 60 27 27 27 27 27 28 27 27 60 27 27 27 27 27 27 27 26 26 27 27 27 27 27 27 28 27 27 27 27 27 27 27 27 27 27 27 6 
0 0 0 0 0 0 0 0 0 0 0 0 0 0 0 0 6 27 58 27 27 28 27 27 27 27 119 27 120 27 27 28 27 40 0 0 0 0 0 0 0 0 0 0 0 0 6 28 27 27 27 27 60 27 27 27 60 27 28 27 27 27 27 27 27 27 27 27 27 27 27 27 27 27 27 27 27 27 27 27 27 27 27 27 27 27 27 27 27 27 27 27 27 27 27 27 27 27 26 6 
0 0 0 0 0 0 0 0 0 0 0 0 0 0 0 0 6 27 27 27 27 27 30 27 27 27 62 27 27 27 27 27 27 42 0 0 0 0 0 0 0 0 0 0 0 0 6 27 26 27 27 29 27 28 27 27 27 27 27 27 27 27 27 27 27 28 27 27 27 27 27 27 27 27 27 27 27 28 27 10 25 25 25 25 25 25 102 48 50 103 25 25 25 25 25 25 11 27 27 6 
0 0 0 0 0 0 0 0 0 0 0 0 0 0 0 0 6 27 27 27 27 28 27 27 27 28 27 27 27 28 30 27 28 44 0 0 0 0 0 0 0 0 0 0 0 0 6 27 28 27 27 27 27 27 10 92 92 16 27 27 17 93 93 14 25 25 102 47 49 103 25 25 25 25 25 25 25 25 25 23 0 0 0 0 0 0 0 0 0 0 0 0 0 0 0 0 6 27 27 6 
0 0 0 0 0 0 10 88 15 15 15 15 109 15 15 93 9 27 27 27 27 62 27 27 27 27 27 27 27 27 27 27 27 46 0 0 0 0 0 0 0 0 0 0 0 0 6 27 27 27 26 27 27 27 6 98 98 27 26 28 27 99 99 6 0 0 0 0 0 0 0 0 0 0 0 0 0 0 0 0 0 0 0 0 0 0 0 0 0 0 0 0 0 0 0 0 6 27 27 6 
0 0 0 0 0 0 6 94 62 57 27 58 117 28 62 99 18 107 89 90 91 15 16 27 27 17 15 15 15 14 25 25 25 25 0 0 0 0 0 0 0 0 0 0 0 0 6 27 27 27 27 27 60 27 6 60 28 27 27 27 27 27 27 6 0 0 0 0 0 0 0 0 0 0 0 0 0 0 0 0 0 0 0 0 0 0 0 0 0 0 0 0 0 0 0 0 6 27 27 6 
0 0 0 0 0 0 6 28 27 27 27 27 27 27 27 27 61 67 95 96 97 27 26 27 27 27 63 60 62 6 0 0 0 0 0 0 0 0 0 6 31 32 33 33 32 34 6 27 27 27 27 27 27 27 6 26 27 27 29 28 27 27 59 6 0 0 0 0 0 0 0 0 0 0 0 0 0 0 0 0 0 0 0 0 0 0 0 0 0 0 0 0 0 0 0 0 6 27 27 6 
0 0 0 0 0 0 6 59 26 27 27 27 27 27 60 27 27 68 27 58 59 27 27 27 27 28 67 27 28 6 0 0 0 0 0 0 0 0 0 6 36 37 38 38 37 39 6 27 27 27 27 27 27 27 6 54 27 27 27 27 27 27 26 6 0 0 0 0 0 0 0 0 0 0 0 0 0 0 0 0 0 0 0 0 0 0 0 0 0 0 0 0 0 0 0 0 6 27 27 6 
0 0 0 0 0 0 6 27 27 58 59 27 27 27 28 27 27 27 26 27 27 27 27 60 27 27 67 51 52 6 0 0 0 0 0 0 0 0 0 6 26 27 27 27 27 27 21 27 27 27 60 27 27 27 6 54 27 28 27 27 27 53 60 6 0 0 0 0 0 0 0 0 0 0 0 0 0 0 0 0 0 0 0 0 0 0 0 0 0 0 0 0 0 0 0 0 6 27 27 6 
0 0 0 0 0 0 6 51 52 60 27 27 27 27 27 61 72 73 27 27 27 57 27 27 27 58 68 55 56 6 0 0 0 0 0 0 0 0 0 6 27 27 28 27 27 27 27 27 30 27 27 29 28 27 6 54 27 26 60 60 27 26 53 6 0 0 0 0 0 0 0 0 0 0 0 0 0 0 0 0 0 0 0 0 0 0 0 0 0 0 0 0 0 0 0 0 6 27 27 6 
0 0 0 0 0 0 6 55 56 62 28 58 27 53 53 54 76 77 27 28 60 27 27 26 28 27 27 26 60 6 0 0 0 0 0 0 0 0 0 6 27 27 27 27 26 27 27 27 27 27 27 27 27 27 6 65 66 27 64 66 29 64 65 6 0 0 0 0 0 0 0 0 0 0 0 0 0 0 0 0 0 0 0 0 0 0 0 0 0 0 0 0 0 0 0 0 6 26 27 6 
0 0 0 0 0 0 22 25 25 25 25 25 25 25 25 25 25 25 25 25 25 25 25 25 25 25 25 25 25 23 0 0 0 0 0 0 0 0 0 6 27 29 27 60 27 27 7 27 28 26 27 27 26 27 6 70 71 27 70 71 28 72 73 6 0 0 0 0 0 0 0 0 0 0 0 0 0 0 0 0 0 0 0 0 0 0 0 0 0 0 0 0 0 0 0 0 6 26 27 6 
0 0 0 0 0 0 0 0 0 0 0 0 0 0 0 0 0 0 0 0 0 0 0 0 0 0 0 0 0 0 0 0 0 0 0 0 0 0 0 6 27 27 27 27 27 27 6 27 27 27 27 27 27 27 6 74 75 28 74 75 27 76 77 6 0 0 0 0 0 0 0 0 0 0 0 0 0 0 0 0 0 0 0 0 0 0 0 0 0 0 0 0 0 0 0 0 6 27 27 6 
0 0 0 0 0 0 0 0 0 0 0 0 0 0 0 0 0 0 0 0 0 0 0 0 0 0 0 0 0 0 0 0 0 0 0 0 0 0 0 6 27 27 27 27 28 27 8 25 25 25 25 25 25 25 24 25 25 25 25 25 25 25 25 23 0 0 0 0 0 0 0 0 0 0 0 0 0 0 0 0 0 0 0 0 0 0 0 0 0 0 0 0 0 0 0 0 6 27 27 6 
0 0 0 0 0 0 0 0 0 0 0 0 0 0 0 0 0 0 0 0 0 0 0 0 0 0 0 0 0 0 0 0 0 0 0 0 0 0 0 6 27 30 27 27 27 27 6 0 0 0 0 0 0 0 0 0 0 0 0 0 0 0 0 0 0 0 0 0 0 0 0 0 0 0 0 0 0 0 0 0 0 0 0 0 0 0 0 0 0 0 0 0 0 0 0 0 6 27 27 6 
10 15 109 109 81 82 81 82 15 81 82 81 82 110 110 15 11 0 0 0 0 0 0 0 0 0 0 0 0 0 0 0 0 0 0 0 0 0 0 6 27 27 26 27 27 27 6 0 0 0 0 0 0 0 0 0 0 0 0 0 0 0 0 0 0 0 0 0 0 0 0 0 0 0 0 0 0 0 0 0 0 0 0 0 0 0 0 0 0 0 0 0 0 0 0 0 6 27 27 6 
6 27 117 117 74 75 74 75 27 74 75 74 75 118 118 27 6 0 0 0 0 0 0 0 0 0 0 0 0 0 0 0 0 0 0 0 0 0 0 6 27 28 27 27 27 27 6 0 0 0 0 0 0 0 0 0 0 0 0 0 0 0 0 0 0 0 0 0 0 0 0 0 0 0 0 0 0 0 0 0 0 0 0 0 0 0 0 0 0 0 0 0 0 0 0 0 6 27 27 6 
6 27 27 64 65 65 65 66 27 64 65 65 65 66 27 26 6 0 0 0 0 0 0 0 0 0 0 0 0 0 0 0 0 0 0 0 0 0 0 6 27 27 27 27 60 27 21 0 0 0 0 0 0 0 0 0 0 0 0 0 0 0 0 0 0 0 0 0 0 0 0 0 0 0 0 0 0 0 0 0 0 0 0 0 0 0 0 0 0 0 0 0 0 0 0 0 6 27 27 6 
6 27 60 27 27 27 27 27 27 27 26 27 27 27 60 27 6 0 0 0 0 0 0 0 0 0 0 0 0 0 0 0 0 0 0 0 0 0 0 6 27 27 27 27 27 27 40 0 0 0 0 0 0 0 0 0 0 0 0 0 0 0 0 0 0 0 0 0 0 0 0 0 0 0 0 0 0 0 0 0 0 0 0 0 0 0 0 0 0 0 0 0 0 0 0 0 21 27 26 6 
6 62 27 27 27 27 27 27 27 28 27 27 27 27 27 27 6 0 0 0 0 0 0 0 0 0 0 0 0 0 0 0 0 0 0 0 0 0 0 6 27 27 60 27 27 27 42 0 0 0 0 0 0 0 0 0 0 0 0 0 0 0 0 0 0 0 0 0 0 0 0 0 0 0 0 0 0 0 0 0 0 0 0 0 0 0 0 0 0 0 0 0 0 0 0 0 35 27 27 6 
6 27 27 27 27 26 27 27 27 27 27 27 26 27 28 27 6 0 0 0 0 0 0 0 0 0 0 0 0 0 0 0 0 0 0 0 0 0 0 6 27 27 27 30 28 27 7 0 0 0 0 0 0 0 0 0 0 0 0 0 0 0 0 0 0 0 0 0 0 0 0 0 0 0 0 0 0 0 0 0 0 0 0 0 0 0 0 0 0 0 0 0 0 0 0 0 45 27 27 6 
6 27 26 27 27 27 27 60 27 27 60 27 27 27 27 62 6 0 0 0 0 0 0 0 0 0 0 0 0 0 0 0 0 0 0 0 0 0 0 6 27 27 27 27 27 27 6 0 0 0 0 0 0 0 0 0 0 0 0 0 0 0 0 0 0 0 0 0 0 0 0 0 0 0 0 0 0 0 0 0 0 0 0 0 0 0 0 0 0 0 0 0 0 0 0 0 7 27 27 6 
8 15 15 15 15 15 15 16 27 27 17 15 15 15 15 15 20 15 15 15 16 31 32 17 15 15 15 92 15 15 15 15 15 15 15 15 15 15 15 19 27 27 27 27 27 27 18 15 15 15 15 15 15 15 15 15 15 15 0 0 0 0 0 0 0 0 0 0 0 0 0 0 0 0 0 0 0 0 0 0 0 0 0 0 0 0 0 0 0 0 0 0 0 0 0 0 6 27 27 6 
6 27 27 27 27 27 27 27 27 27 27 27 27 26 27 27 27 27 27 27 27 36 37 27 27 27 27 98 27 27 27 27 27 27 27 60 26 27 27 27 27 28 27 27 60 27 27 27 27 27 27 27 27 27 27 27 27 40 0 0 0 0 0 0 0 0 0 0 0 0 0 0 0 0 0 0 0 0 0 0 0 0 0 0 0 0 0 0 0 0 0 0 0 0 0 0 6 27 27 6 
6 27 27 28 27 26 27 27 27 60 27 27 27 27 60 27 27 27 27 27 60 27 27 28 27 27 28 27 27 27 60 60 27 27 60 27 27 27 27 27 27 27 27 27 27 27 27 27 28 27 60 60 27 27 28 27 27 42 0 0 0 0 0 0 0 0 0 0 0 0 10 81 82 81 82 81 82 81 82 81 82 83 84 15 15 15 15 81 82 81 82 81 82 15 15 15 9 27 27 6 
6 27 26 27 27 27 27 27 27 27 26 28 27 27 27 27 26 28 27 27 27 27 26 27 27 27 27 26 27 27 27 27 27 27 27 27 27 27 28 27 27 26 27 27 28 27 27 27 27 27 27 27 27 27 27 27 60 44 0 0 0 0 0 0 0 0 0 0 0 0 6 74 75 74 75 74 75 74 75 74 75 76 77 27 28 27 62 74 75 74 75 74 75 62 27 27 6 26 27 6 
6 27 27 27 27 27 27 27 27 27 27 27 27 27 27 27 27 27 27 27 27 27 27 27 27 27 27 27 27 27 27 27 27 28 27 27 27 27 27 27 27 27 27 27 27 27 27 27 26 27 27 27 27 27 27 27 27 46 0 0 0 0 0 0 0 0 0 0 0 0 6 64 65 65 65 65 65 65 65 65 65 65 66 27 27 27 27 64 65 65 65 65 66 27 26 27 6 27 27 6 
8 15 15 15 15 15 15 16 27 27 17 15 15 15 15 14 15 108 108 15 16 27 27 17 109 109 108 15 15 15 14 25 25 25 25 25 25 25 25 25 25 14 15 15 15 106 15 15 15 16 27 28 17 15 106 15 106 11 0 0 0 0 0 0 0 0 0 0 0 0 6 27 27 27 27 27 27 26 60 27 27 27 27 28 27 29 27 27 27 26 27 27 27 27 28 27 6 27 29 6 
6 27 27 27 27 27 27 27 27 27 27 27 27 27 27 6 27 116 116 27 27 27 27 27 117 117 116 27 27 60 6 0 0 0 0 0 0 0 0 0 0 6 27 57 27 115 27 58 59 27 26 27 26 27 115 27 115 6 0 0 0 0 0 0 0 0 0 0 0 0 6 27 62 27 27 28 27 27 27 27 27 26 27 27 27 62 27 27 27 27 27 27 27 27 27 60 6 27 27 6 
6 27 27 28 27 27 26 27 27 60 27 27 27 27 27 6 27 27 27 27 27 27 63 27 70 71 70 71 70 71 6 0 0 0 0 0 0 0 0 0 0 6 26 27 27 27 28 27 60 27 27 27 27 27 28 27 58 6 0 0 0 0 0 0 0 0 0 0 0 0 6 64 65 65 65 65 65 65 65 65 65 65 66 27 27 27 27 64 65 65 65 65 66 26 27 27 21 27 27 6 
6 27 26 26 27 27 27 27 27 27 27 27 27 28 27 6 27 28 27 60 26 27 67 27 74 75 74 75 74 75 6 0 0 0 0 0 0 0 0 0 0 6 58 59 27 27 27 28 27 27 26 27 53 54 27 27 27 6 0 0 0 0 0 0 0 0 0 0 0 0 6 70 71 72 73 70 71 70 71 72 73 70 71 27 27 60 27 70 71 70 71 72 73 27 27 62 27 27 27 6 
6 27 27 27 27 60 27 27 27 28 28 27 27 27 27 6 27 29 27 27 27 27 67 28 27 27 27 26 28 30 6 0 0 0 0 0 0 0 0 0 0 6 27 27 54 27 53 54 27 27 27 27 53 27 27 26 27 6 0 0 0 0 0 0 0 0 0 0 0 0 6 74 75 76 77 74 75 74 75 76 77 74 75 27 27 28 27 74 75 74 75 76 77 27 29 27 27 27 27 6 
6 27 27 27 27 27 27 10 109 83 84 83 84 83 84 19 27 27 27 27 27 27 67 27 72 73 72 73 72 73 6 0 0 0 0 0 0 0 0 0 0 6 27 27 27 27 27 27 58 27 27 27 28 51 52 60 27 6 0 0 0 0 0 0 0 0 0 0 0 0 6 64 65 65 65 65 65 65 65 65 65 65 66 60 27 27 27 64 65 65 65 65 66 27 28 27 7 27 27 6 
6 27 27 28 27 27 27 6 117 76 77 76 77 76 77 27 27 26 27 28 27 29 67 27 76 77 76 77 76 77 6 0 0 0 0 0 0 0 0 0 0 6 57 27 27 26 27 27 27 27 26 27 27 55 56 27 58 6 0 0 0 0 0 0 0 0 0 0 0 0 6 27 26 27 27 27 27 28 27 27 27 27 27 27 27 27 27 28 27 27 27 27 27 27 27 26 6 47 50 6 
6 27 27 27 27 27 27 6 27 64 65 65 65 65 66 27 27 27 27 27 27 27 67 27 27 27 27 27 60 27 6 0 0 0 0 0 0 0 0 0 0 6 27 60 28 53 27 27 28 27 27 53 27 27 27 27 27 6 0 0 0 0 0 0 0 0 0 0 0 0 22 25 25 25 25 25 25 25 25 25 25 25 25 25 25 25 25 25 25 25 25 25 25 25 25 25 23 0 0 0 
6 27 27 27 27 60 27 6 30 28 27 60 27 27 27 27 27 29 27 27 28 27 67 30 70 71 70 71 72 73 6 0 0 0 0 0 0 0 0 0 0 6 26 27 27 27 27 54 27 27 27 27 27 27 28 54 27 6 0 0 0 0 0 0 0 0 0 0 0 0 0 0 0 0 0 0 0 0 0 0 0 0 0 0 0 0 0 0 0 0 0 0 0 0 0 0 0 0 0 0 
6 27 26 27 27 27 27 6 27 27 27 27 27 28 27 26 27 27 27 60 27 27 67 27 74 75 74 75 76 77 6 0 0 0 0 0 0 0 0 0 0 6 53 54 27 26 27 27 27 60 26 27 58 27 58 27 54 6 0 0 0 0 0 0 0 0 0 0 0 0 0 0 0 0 0 0 0 0 0 0 0 0 0 0 0 0 0 0 0 0 0 0 0 0 0 0 0 0 0 0 
6 27 27 27 27 28 27 18 15 15 15 15 15 15 15 15 15 15 15 15 15 15 15 15 15 15 15 15 15 15 20 15 15 15 16 31 32 17 15 15 15 20 15 15 15 15 15 15 15 15 15 15 15 15 15 15 15 20 15 0 0 0 0 0 0 0 0 0 0 0 0 0 0 0 0 0 0 0 0 0 0 0 0 0 0 0 0 0 0 0 0 0 0 0 0 0 0 0 0 0 
6 27 27 27 27 27 27 27 27 27 27 27 27 60 27 27 27 27 27 28 27 27 27 27 27 27 27 27 27 27 27 27 27 27 27 36 37 27 60 27 27 27 27 27 27 27 27 27 27 27 27 27 27 27 27 27 27 27 40 0 0 0 0 0 0 0 0 0 0 0 0 0 0 0 0 0 0 0 0 0 0 0 0 0 0 0 0 0 0 0 0 0 0 0 0 0 0 0 0 0 
6 27 27 28 29 27 27 27 27 27 27 27 27 27 27 27 27 27 27 27 27 27 26 27 27 27 60 60 27 27 27 27 27 30 27 27 27 27 27 27 27 27 28 27 26 27 27 60 27 27 27 27 26 27 60 27 27 27 42 0 0 0 0 0 0 0 0 0 0 0 0 0 0 0 0 0 0 0 0 0 0 0 0 0 0 0 0 0 0 0 0 0 0 0 0 0 0 0 0 0 
6 27 27 27 27 27 27 27 27 28 27 27 27 26 27 27 28 29 27 27 27 27 27 27 27 27 27 27 27 27 60 27 27 27 27 26 27 27 28 29 27 27 27 27 27 27 27 27 27 27 26 27 27 27 27 27 27 27 44 0 0 0 0 0 0 0 0 0 0 0 0 0 0 0 0 0 0 0 0 0 0 0 0 0 0 0 0 0 0 0 0 0 0 0 0 0 0 0 0 0 
6 27 27 27 27 27 27 27 27 27 27 27 27 27 27 27 27 27 27 27 60 60 27 27 27 28 27 27 26 27 27 27 27 27 27 27 27 27 27 27 27 27 27 60 27 27 27 27 27 27 27 27 28 27 27 28 27 27 46 0 0 0 0 0 0 0 0 0 0 0 0 0 0 0 0 0 0 0 0 0 0 0 0 0 0 0 0 0 0 0 0 0 0 0 0 0 0 0 0 0 
6 47 48 49 48 49 50 10 25 25 25 25 25 25 25 25 25 25 25 25 25 25 25 25 25 25 25 25 25 25 25 25 25 25 102 47 50 103 25 25 25 25 25 25 25 25 25 25 25 25 11 27 29 27 60 27 27 10 15 15 106 15 15 15 15 15 106 15 15 15 15 106 15 15 11 0 0 0 0 0 0 0 0 0 0 0 0 0 0 0 0 0 0 0 0 0 0 0 0 0 
0 0 0 0 0 0 0 0 0 0 0 0 0 0 0 0 0 0 0 0 0 0 0 0 0 0 0 0 0 0 0 0 0 0 0 0 0 0 0 0 0 0 0 0 0 0 0 0 0 0 6 27 27 27 27 27 27 6 27 27 115 27 27 27 57 27 115 27 27 27 27 115 27 58 6 0 0 0 0 0 0 0 0 0 0 0 0 0 0 0 0 0 0 0 0 0 0 0 0 0 
0 0 0 0 0 0 0 0 0 0 0 0 0 0 0 0 0 0 0 0 0 0 0 0 0 0 0 0 0 0 0 0 0 0 0 0 0 0 0 0 0 0 0 0 0 0 0 0 0 0 6 27 27 28 27 27 27 6 60 27 53 54 27 27 27 26 27 60 60 27 27 27 58 59 6 0 0 0 0 0 0 0 0 0 0 0 0 0 0 0 0 0 0 0 0 0 0 0 0 0 
0 0 0 0 0 0 0 0 0 0 0 0 0 0 0 0 0 0 0 0 0 0 0 0 0 0 0 0 0 0 0 0 0 0 0 0 0 0 0 0 0 0 0 0 0 0 0 0 0 0 6 27 27 27 27 58 27 6 27 27 26 27 53 27 27 27 53 27 27 53 27 27 27 27 6 0 0 0 0 0 0 0 0 0 0 0 0 0 0 0 0 0 0 0 0 0 0 0 0 0 
0 0 0 0 0 0 0 0 0 0 0 0 0 0 0 0 0 0 0 0 0 0 0 0 0 0 0 0 0 0 0 0 0 0 0 0 0 0 0 0 0 0 0 0 0 0 0 0 0 0 6 27 27 26 27 27 27 6 27 30 28 27 53 54 27 27 27 27 27 27 27 27 53 27 6 0 0 0 0 0 0 0 0 0 0 0 0 0 0 0 0 0 0 0 0 0 0 0 0 0 
0 0 0 0 0 0 0 0 0 0 0 0 0 0 0 0 0 0 0 0 0 0 0 0 0 0 0 0 0 0 0 0 0 0 0 0 0 0 0 0 0 0 0 0 0 0 0 0 0 0 6 27 27 27 27 27 27 6 27 27 60 27 26 27 27 26 27 27 29 26 60 27 27 27 6 0 0 0 0 0 0 0 0 0 0 0 0 0 0 0 0 0 0 0 0 0 0 0 0 0 
0 0 0 0 0 0 0 0 0 0 0 0 0 0 0 0 0 0 0 0 0 0 0 0 0 0 0 0 0 0 0 0 0 0 0 0 0 0 0 0 0 0 0 0 0 0 0 0 0 0 6 27 27 27 27 27 27 6 27 53 27 27 27 27 27 28 27 27 27 27 27 27 27 26 6 0 0 0 0 0 0 0 0 0 0 0 0 0 0 0 0 0 0 0 0 0 0 0 0 0 
0 0 0 0 0 0 0 0 0 0 0 0 0 0 0 0 0 0 0 0 0 0 0 0 0 0 0 0 0 0 0 0 0 0 0 0 0 0 0 0 0 0 0 0 0 0 0 0 0 0 6 27 28 58 27 60 27 6 27 27 27 27 53 27 29 27 27 53 54 27 26 27 27 57 6 0 0 0 0 0 0 0 0 0 0 0 0 0 0 0 0 0 0 0 0 0 0 0 0 0 
0 0 0 0 0 0 0 0 0 0 0 0 0 0 0 0 0 0 0 0 0 0 0 0 0 0 0 0 0 0 0 0 0 0 0 0 0 0 0 0 0 0 0 0 0 0 0 0 0 0 6 27 27 27 27 27 27 6 27 27 28 27 27 27 28 27 30 27 27 26 27 29 53 27 6 0 0 0 0 0 0 0 0 0 0 0 0 0 0 0 0 0 0 0 0 0 0 0 0 0 
0 0 0 0 0 0 0 0 0 0 0 0 0 0 0 0 0 0 0 0 0 0 0 0 0 0 0 0 0 0 0 0 0 0 0 0 0 0 0 0 0 0 0 0 0 0 0 0 0 0 6 27 27 27 27 27 27 6 27 58 27 60 27 27 27 27 28 27 27 27 27 27 27 27 6 0 0 0 0 0 0 0 0 0 0 0 0 0 0 0 0 0 0 0 0 0 0 0 0 0 
0 0 0 0 0 0 0 0 0 0 0 0 0 0 0 0 0 0 0 0 0 0 0 0 0 0 0 0 10 15 81 82 81 82 81 82 81 82 81 82 81 82 15 108 108 108 15 109 109 109 9 27 60 27 28 27 27 6 27 27 27 28 27 53 27 27 26 27 27 53 54 27 60 27 6 0 0 0 0 0 0 0 0 0 0 0 0 0 0 0 0 0 0 0 0 0 0 0 0 0 
0 0 0 0 0 0 0 0 0 0 0 0 0 0 0 0 0 0 0 0 0 0 0 0 0 0 0 0 6 27 74 75 74 75 74 75 74 75 74 75 74 75 27 116 116 116 28 117 117 117 6 27 27 27 27 26 27 6 27 51 52 27 27 27 27 27 29 27 26 27 27 27 28 27 6 0 0 0 0 0 0 0 0 0 0 0 0 0 0 0 0 0 0 0 0 0 0 0 0 0 
0 0 0 0 0 0 0 0 0 0 0 0 0 0 0 0 0 0 0 0 0 0 0 0 0 0 0 0 6 27 64 65 65 65 65 65 65 65 65 65 65 66 27 27 26 27 27 27 30 27 6 27 27 27 27 27 27 6 27 55 56 27 27 58 59 27 27 27 27 27 27 29 27 27 6 0 0 0 0 0 0 0 0 0 0 0 0 0 0 0 0 0 0 0 0 0 0 0 0 0 
0 0 0 0 0 0 0 0 0 0 0 0 0 0 0 0 0 0 0 0 0 0 0 0 0 0 0 0 6 62 27 28 27 27 26 27 27 27 27 27 27 27 27 27 27 27 27 27 27 53 6 27 28 27 27 60 27 8 15 15 15 15 15 15 15 15 15 15 15 16 27 27 17 15 9 0 0 0 0 0 0 0 0 0 0 0 0 0 0 0 0 0 0 0 0 0 0 0 0 0 
0 0 0 0 0 0 0 0 0 0 0 0 0 0 0 0 0 0 0 0 0 0 0 0 0 0 0 0 6 27 27 27 30 27 27 27 28 27 27 27 27 27 60 30 27 27 27 26 28 60 6 27 27 27 27 27 27 6 27 58 27 27 27 27 27 27 27 27 27 27 28 27 27 27 6 0 0 0 0 0 0 0 0 0 0 0 0 0 0 0 0 0 0 0 0 0 0 0 0 0 
0 0 0 0 0 0 0 0 0 0 0 0 0 0 0 0 0 0 0 0 0 0 0 0 0 0 0 0 6 27 70 71 70 71 70 71 70 71 70 71 70 71 27 27 53 27 30 27 27 27 6 27 26 27 27 58 27 6 27 27 27 27 27 27 27 53 27 27 28 27 27 26 60 27 6 0 0 0 0 0 0 0 0 0 0 0 0 0 0 0 0 0 0 0 0 0 0 0 0 0 
0 0 0 0 0 0 0 0 0 0 0 0 0 0 0 0 0 0 0 0 0 0 0 0 0 0 0 0 6 27 74 75 74 75 74 75 74 75 74 75 74 75 27 27 27 26 27 27 27 27 21 27 27 27 28 27 27 21 27 27 27 27 53 27 26 29 27 27 27 27 27 53 53 27 6 0 0 0 0 0 0 0 0 0 0 0 0 0 0 0 0 0 0 0 0 0 0 0 0 0 
0 0 0 0 0 0 0 0 0 0 0 0 0 0 0 0 0 0 0 0 0 0 0 0 0 0 0 0 6 28 64 65 65 65 65 65 65 65 65 65 65 66 27 27 27 27 27 53 27 27 27 27 27 27 27 27 27 27 27 27 60 27 27 27 27 27 27 53 60 60 27 27 27 27 6 0 0 0 0 0 0 0 0 0 0 0 0 0 0 0 0 0 0 0 0 0 0 0 0 0 
0 0 0 0 0 0 0 0 0 0 0 0 0 0 0 0 0 0 0 0 0 0 0 0 0 0 0 0 6 27 27 26 27 27 27 27 30 27 27 27 27 27 27 27 59 27 27 27 27 27 27 27 26 28 30 27 27 27 27 27 28 27 27 27 27 28 27 27 28 27 27 28 27 27 6 0 0 0 0 0 0 0 0 0 0 0 0 0 0 0 0 0 0 0 0 0 0 0 0 0 
0 0 0 0 0 0 0 0 0 0 0 0 0 0 0 0 0 0 0 0 0 0 0 0 0 0 0 0 6 60 27 27 27 27 27 28 27 27 27 62 27 27 27 26 27 27 27 27 28 27 7 27 27 58 27 60 27 7 27 27 27 54 27 60 27 27 27 27 27 27 27 27 27 53 6 0 0 0 0 0 0 0 0 0 0 0 0 0 0 0 0 0 0 0 0 0 0 0 0 0 
0 0 0 0 0 0 0 0 0 0 0 0 0 0 0 0 0 0 0 0 0 0 0 0 0 0 0 0 6 27 70 71 70 71 70 71 70 71 70 71 70 71 27 27 27 27 27 27 27 60 6 27 27 27 27 27 27 6 27 27 27 27 28 27 53 54 27 27 53 27 28 54 27 27 6 0 0 0 0 0 0 0 0 0 0 0 0 0 0 0 0 0 0 0 0 0 0 0 0 0 
0 0 0 0 0 0 0 0 0 0 0 0 0 0 0 0 0 0 0 0 0 0 0 0 0 0 0 0 6 27 74 75 74 75 74 75 74 75 74 75 74 75 27 27 27 53 59 27 27 27 6 27 27 27 27 27 27 6 58 27 26 27 27 27 27 27 27 28 27 27 27 27 27 59 6 0 0 0 0 0 0 0 0 0 0 0 0 0 0 10 92 92 108 78 79 80 89 90 91 11 
0 0 0 0 0 0 0 0 0 0 0 0 0 0 0 0 0 0 0 0 0 0 0 0 0 0 0 0 6 27 64 65 65 65 65 65 65 65 65 65 65 66 27 27 27 27 27 26 27 27 6 27 27 27 27 27 27 8 25 25 25 25 25 25 25 25 25 25 25 25 25 25 25 25 23 0 0 0 0 0 0 0 0 0 0 0 0 0 0 6 98 98 116 85 86 87 95 96 97 6 
0 0 0 0 0 0 0 0 0 0 0 0 0 0 0 0 0 0 0 0 0 0 0 0 0 0 0 0 6 27 62 27 27 27 27 27 27 27 27 27 27 27 27 60 27 26 27 27 27 27 6 27 27 60 60 27 27 6 0 0 0 0 0 0 0 0 0 0 0 0 0 0 0 0 0 0 0 0 0 0 0 0 0 0 0 0 0 0 0 6 29 27 27 26 27 27 27 28 27 6 
0 0 0 0 0 0 0 0 0 0 0 0 0 0 0 0 0 0 0 0 0 0 0 0 0 0 0 0 6 27 27 27 27 26 27 27 27 30 27 28 27 27 27 59 27 27 27 27 62 59 6 27 27 27 27 27 58 6 0 0 0 0 0 0 0 0 0 0 0 0 0 0 0 0 0 0 0 0 0 0 0 0 0 0 0 0 0 0 0 6 27 28 60 27 28 27 60 27 58 6 
0 0 0 0 0 0 0 0 0 0 0 0 0 0 0 0 0 0 0 0 0 0 0 0 0 0 0 0 22 25 25 25 25 25 25 25 25 25 25 25 25 25 25 25 25 25 25 25 25 25 9 27 27 28 27 27 27 6 0 0 0 0 0 0 0 0 0 0 0 0 0 0 0 0 0 0 0 0 0 0 0 0 0 0 0 0 0 0 0 6 27 26 27 27 27 27 27 27 27 6 
0 0 0 0 0 0 0 0 0 0 0 0 0 0 0 0 0 0 0 0 0 0 0 0 0 0 0 0 0 0 0 0 0 0 0 0 0 0 0 0 0 0 0 0 0 0 0 0 0 0 6 27 27 26 28 27 27 6 0 0 0 0 0 0 0 0 0 0 0 0 0 0 0 0 0 0 0 0 0 0 0 0 0 0 0 0 0 0 0 6 27 58 27 27 29 27 27 62 27 6 
0 0 0 0 0 0 0 0 0 0 0 0 0 0 0 0 0 0 0 0 0 0 0 0 0 0 0 0 0 0 0 0 0 0 0 0 0 0 0 0 0 0 0 0 0 0 0 0 0 0 6 27 27 27 27 28 27 6 0 0 0 0 0 0 0 0 0 0 0 0 0 0 0 0 0 0 0 0 0 0 0 0 0 0 0 0 0 0 0 6 27 27 62 27 27 28 27 26 27 6 
0 0 0 0 0 0 0 0 0 0 0 0 0 0 0 0 0 0 0 0 0 0 0 0 0 0 0 0 0 0 0 0 0 0 0 0 0 0 0 0 0 0 0 0 0 0 0 0 0 0 6 27 27 27 27 30 27 6 0 0 0 0 0 0 0 0 0 0 0 0 0 0 0 0 0 0 0 0 0 0 0 0 0 0 0 0 0 0 0 6 27 28 27 27 27 27 27 27 26 6 
0 0 0 0 0 0 0 0 0 0 0 0 0 0 0 0 0 0 0 0 0 0 0 0 0 0 0 0 0 0 0 0 0 0 0 0 0 0 0 0 0 0 0 0 0 0 0 0 0 0 6 27 28 26 27 27 27 6 0 0 0 0 0 0 0 0 0 0 0 0 0 0 0 0 0 0 0 0 0 0 0 0 0 0 0 0 0 0 0 6 27 29 27 27 28 62 27 62 28 6 
0 0 0 0 0 0 0 0 0 0 0 0 0 0 0 0 0 0 0 0 0 0 0 0 0 0 0 0 0 0 0 0 0 0 0 0 0 0 0 0 0 0 0 0 0 0 0 0 0 0 6 27 27 27 27 28 27 6 0 0 0 0 0 0 0 0 0 0 0 0 0 0 0 0 0 0 0 0 0 0 0 0 0 0 0 0 0 0 0 6 53 56 26 27 27 27 27 27 58 6 
0 0 0 0 0 0 0 0 0 0 0 0 0 0 0 0 0 0 0 0 0 0 0 0 0 0 0 0 0 0 0 0 0 0 0 0 0 0 0 0 0 0 0 0 0 0 0 0 0 0 19 27 27 27 27 27 27 18 15 15 15 15 15 15 15 108 15 15 15 15 15 109 109 109 15 15 15 15 15 15 15 15 15 15 15 15 15 15 15 20 15 15 15 15 15 16 100 101 17 9 
0 0 0 0 0 0 0 0 0 0 0 0 0 0 0 0 0 0 0 0 0 0 0 0 0 0 0 0 0 0 0 0 0 0 0 0 0 0 0 0 0 0 0 0 0 0 0 0 0 0 35 27 27 27 27 27 27 27 27 27 27 27 27 27 27 116 27 27 27 28 27 117 117 117 27 27 26 27 27 27 27 27 27 28 30 27 27 27 27 26 27 27 27 27 27 27 27 27 28 6 
0 0 0 0 0 0 0 0 0 0 0 0 0 0 0 0 0 0 0 0 0 0 0 0 0 0 0 0 0 0 0 0 0 0 0 0 0 0 0 0 0 0 0 0 0 0 0 0 0 0 41 27 28 27 27 60 27 27 27 27 60 60 27 27 28 27 30 30 27 26 27 30 27 27 27 27 27 27 27 27 27 27 27 27 27 27 27 27 27 27 27 27 28 27 27 60 27 27 27 6 
0 0 0 0 0 0 0 0 0 0 0 0 0 0 0 0 0 0 0 0 0 0 0 0 0 0 0 0 0 0 0 0 0 0 0 0 0 0 0 0 0 0 0 0 0 0 0 0 0 0 43 27 27 27 27 27 27 27 27 27 26 26 27 27 27 27 27 27 27 27 28 27 27 60 27 27 27 60 27 27 28 27 27 26 27 60 27 27 28 27 30 27 27 27 27 28 27 60 27 6 
0 0 0 0 0 0 0 0 0 0 0 0 0 0 0 0 0 0 0 0 0 0 0 0 0 0 0 0 0 0 0 0 0 0 0 0 0 0 0 0 0 0 0 0 0 0 0 0 0 0 45 27 27 26 27 27 27 27 27 27 27 27 27 27 27 27 60 27 27 27 27 27 27 27 27 27 27 27 27 27 27 27 27 27 27 27 27 27 27 27 27 27 27 27 26 27 27 27 27 6 
0 0 0 0 0 0 0 0 0 0 0 0 0 0 0 0 0 0 0 0 0 0 0 0 0 0 0 0 0 0 0 0 0 0 0 0 0 0 0 0 0 0 0 0 0 0 0 0 0 0 25 25 25 25 25 25 25 25 25 25 25 25 25 25 25 25 25 25 25 25 25 25 25 25 25 25 25 25 25 25 25 25 25 25 25 25 25 25 25 25 25 25 25 25 25 25 25 25 25 23 
