11 16 16 250 588 590 250 16 250 578 580 250 250 594 595 596 250 594 595 596 250 16 15 72 250 34 35 250 266 16 16 16 16 16 250 34 35 38 39 250 266 16 16 16 16 16 250 38 39 46 47 250 266 16 16 16 16 16 250 46 47 72 250 16 218 16 16 218 16 16 218 16 218 16 16 218 16 16 16 218 16 16 16 218 16 218 16 15 16 16 16 16 16 46 47 16 16 16 16 12 
7 2 6 265 2 2 265 499 265 2 2 265 265 2 2 2 265 2 2 2 265 2 7 503 265 2 2 265 279 501 2 2 2 503 265 4 2 499 2 265 279 2 329 2 2 2 265 503 2 2 6 265 279 2 497 2 2 2 265 2 2 2 265 6 232 1 1 232 1 1 232 1 232 1 1 232 1 1 1 232 1 1 1 232 1 232 1 7 1 1 1 1 502 1 1 5 1 1 1 7 
7 2 2 2 503 2 2 2 2 4 2 2 2 2 503 2 2 2 499 2 503 2 7 2 2 4 2 329 2 2 339 2 329 2 2 2 2 503 2 2 337 2 2 2 2 329 2 2 2 4 2 2 329 2 2 339 2 329 2 2 2 4 2 503 1 1 1 1 502 1 500 1 1 502 1 1 1 3 1 1 1 502 1 1 1 1 1 7 1 502 336 1 1 1 1 1 500 502 5 7 
7 2 6 2 2 2 6 2 2 503 2 499 2 2 2 2 503 2 2 4 2 2 7 2 497 2 335 422 423 424 425 426 427 428 429 335 2 2 335 437 438 439 440 425 441 442 443 335 2 499 335 422 423 424 425 426 427 428 429 335 2 2 503 8 1 1 500 3 1 1 1 498 1 1 1 1 5 1 1 500 1 1 1 3 1 502 1 7 1 1 1 1 2 2 2 1 1 1 338 7 
7 501 2 2 4 2 2 2 2 2 2 2 2 2 2 2 2 2 501 2 2 2 7 2 2 2 2 444 445 446 447 448 449 450 452 2 2 503 2 461 454 455 456 457 458 459 460 2 2 2 2 444 445 446 447 448 449 450 452 2 2 2 2 7 1 1 1 1 1 1 1 1 1 1 1 1 1 1 1 1 1 1 498 1 1 1 1 7 1 338 498 1 2 2 2 1 3 1 1 7 
9 198 198 198 198 198 16 16 16 16 16 42 43 16 16 12 2 6 2 2 2 2 7 2 499 526 519 470 471 472 473 474 475 476 477 335 2 526 519 486 487 488 489 490 491 492 493 522 523 526 519 470 471 472 473 474 475 476 477 335 2 503 6 9 83 267 267 251 112 113 251 112 113 251 27 28 1 1 29 27 12 1 1 1 5 1 1 7 1 502 5 1 2 2 2 1 1 336 1 7 
7 206 206 206 206 206 502 1 709 503 2 2 2 2 6 7 2 2 503 2 6 6 7 2 2 2 2 2 2 2 501 341 2 341 2 2 2 501 2 2 341 2 2 2 2 339 341 2 2 2 2 2 341 2 2 341 2 2 341 2 2 497 2 7 1 278 278 264 116 117 264 116 117 264 1 1 1 1 502 1 7 1 1 498 1 1 1 7 1 1 1 1 1 1 1 1 502 3 1 7 
7 1 1 3 1 500 1 1 713 2 2 6 2 2 2 7 2 2 2 2 2 2 7 2 503 4 2 499 2 337 503 2 2 4 2 2 497 4 2 6 2 2 329 2 503 2 2 4 2 501 2 503 2 2 4 2 2 499 6 2 2 4 2 7 332 1 1 1 502 1 1 500 1 1 1 5 1 1 3 1 7 1 1 1 1 1 500 7 1 3 1 1 502 1 1 5 1 1 1 7 
7 83 112 113 27 12 1 5 8 331 2 501 2 503 331 7 2 2 6 2 2 2 7 2 2 2 2 2 329 2 329 2 329 2 2 2 503 2 2 2 329 2 2 503 2 329 2 2 2 2 2 2 329 2 2 2 339 329 2 2 2 501 2 7 114 1 5 498 1 1 1 1 1 502 1 1 1 498 1 1 7 1 1 1 3 1 1 7 502 1 1 1 3 1 1 1 1 1 1 7 
7 1 116 117 1 7 1 1 7 343 503 2 2 2 345 7 331 2 2 503 2 331 7 2 497 2 335 437 438 439 440 425 441 442 443 335 2 2 335 422 423 424 425 426 427 428 429 335 2 2 335 437 438 439 440 425 441 442 443 335 2 503 2 7 118 1 1 1 1 1 1 1 1 1 1 1 1 1 1 1 7 1 502 502 1 1 1 7 5 336 502 1 1 1 1 500 1 498 1 7 
7 502 1 1 334 33 1 1 7 343 2 2 2 2 345 7 2 2 2 2 6 2 7 2 2 2 2 461 454 455 456 457 458 459 460 2 2 2 2 444 445 446 447 448 449 450 452 2 2 2 2 461 454 455 456 457 458 459 460 2 2 2 2 7 332 1 1 1 502 1 11 135 251 112 113 251 36 37 251 135 10 1 5 1 1 1 1 7 1 1 498 5 1 338 1 336 1 1 1 7 
7 1 1 498 1 1 498 1 7 331 2 2 499 2 331 7 2 2 501 2 503 2 7 2 6 2 335 486 487 488 489 490 491 492 493 522 523 2 335 470 471 472 473 474 475 476 477 335 2 526 519 486 487 488 489 490 491 492 493 335 2 4 2 7 114 1 1 1 1 1 7 142 264 116 117 232 1 1 264 142 7 1 1 1 1 498 1 19 16 16 16 16 16 16 16 16 16 1 1 7 
7 350 351 352 1 1 1 3 7 343 2 2 2 2 345 7 2 503 2 2 2 2 7 2 503 2 2 2 341 2 2 2 341 2 2 2 497 4 2 341 2 2 2 341 2 2 341 2 2 2 2 2 341 2 6 341 2 341 2 2 2 2 2 7 118 1 1 498 1 1 33 334 1 1 686 687 392 338 1 1 7 498 1 1 1 1 1 1 1 1 1 1 1 1 1 1 1 1 1 7 
7 366 367 368 1 8 1 1 7 343 2 2 503 2 345 7 2 2 2 2 2 499 7 2 2 501 2 2 499 2 339 2 2 2 503 2 2 2 2 2 2 2 337 2 2 329 2 2 4 2 6 2 2 2 2 2 2 329 2 6 503 497 499 7 332 1 1 1 500 1 1 498 1 3 694 695 393 394 1 1 7 1 1 502 1 1 1 1 502 1 3 1 1 1 1 1 1 502 1 7 
7 340 1 1 1 7 1 5 7 331 2 2 2 2 331 7 2 2 6 2 2 2 7 2 4 2 2 2 329 329 2 329 2 2 2 2 6 501 2 2 329 2 2 503 2 2 2 497 499 2 2 2 337 2 2 329 2 4 2 2 2 2 2 7 1 1 502 1 5 1 1 1 1 502 1 334 403 368 1 502 7 1 1 1 1 500 1 5 1 1 1 1 1 500 1 1 1 1 1 7 
7 83 315 27 27 7 1 1 7 343 2 2 2 2 345 7 331 2 2 2 4 331 7 2 497 2 335 422 423 424 425 426 427 428 429 335 2 2 335 437 438 439 440 425 441 442 443 335 2 2 335 422 423 424 425 426 427 428 429 335 2 2 4 7 1 1 1 1 1 1 8 334 1 5 1 1 1 1 3 1 7 1 1 5 1 1 1 1 1 1 1 1 5 1 1 1 1 3 1 7 
7 1 326 1 334 7 1 1 7 343 2 503 501 2 345 7 2 2 2 2 2 2 7 2 2 2 2 444 445 446 447 448 449 450 452 2 2 2 2 461 454 455 456 457 458 459 460 2 2 2 2 444 445 446 447 448 449 450 452 2 2 501 2 9 16 16 16 16 280 280 21 280 280 280 280 280 280 280 280 280 21 280 280 280 280 280 280 280 280 280 280 280 280 280 280 16 16 16 16 10 
7 498 502 1 334 33 1 3 7 2 2 2 2 361 360 7 2 2 2 2 2 503 7 2 2 503 335 470 471 472 473 474 475 476 477 335 2 526 519 486 487 488 489 490 491 492 493 335 2 2 335 470 471 472 473 474 475 476 477 335 2 2 2 7 2 2 2 2 293 293 2 293 293 293 293 293 293 293 293 293 2 293 293 293 293 293 293 293 293 293 293 293 293 293 293 501 2 2 503 7 
7 1 1 1 1 1 1 498 7 2 2 2 2 374 388 7 2 2 503 4 2 2 7 2 6 2 2 2 341 2 2 2 337 341 2 2 503 2 2 2 341 2 337 2 2 341 2 2 2 4 2 341 2 2 2 341 2 2 2 6 2 4 503 7 2 503 4 2 6 2 2 2 501 2 2 2 503 501 2 2 2 2 2 2 503 2 2 2 503 2 2 2 499 2 2 2 2 6 2 7 
7 350 351 352 502 1 5 1 7 335 335 2 2 391 339 7 2 2 2 2 2 2 7 2 2 2 2 2 2 6 2 497 2 2 2 2 2 2 2 2 2 499 2 6 2 2 2 2 501 2 2 2 503 2 2 2 2 341 2 2 2 501 2 7 2 2 499 2 2 2 2 2 2 2 2 2 2 2 2 6 2 2 2 2 2 2 4 2 2 2 2 4 2 2 4 2 503 2 2 7 
7 366 367 368 1 8 502 1 9 16 17 503 2 18 16 10 2 4 2 2 2 4 7 16 234 16 16 234 16 16 234 16 16 234 16 17 2 2 18 16 234 16 16 234 16 16 234 16 16 234 16 16 234 16 16 234 16 16 234 16 16 234 16 10 2 2 2 2 222 16 16 34 35 72 16 16 16 72 34 35 16 218 42 43 218 16 176 266 152 15 82 16 266 42 60 581 582 582 583 7 
7 340 1 1 1 7 1 1 7 499 2 2 2 2 2 7 331 4 2 501 2 331 7 2 249 4 2 249 2 2 249 2 2 249 2 2 503 2 2 2 249 2 2 249 2 2 249 2 2 249 499 2 249 2 2 249 501 2 249 2 2 249 2 7 2 4 2 2 233 2 2 2 2 2 2 2 2 2 2 2 2 233 2 503 233 2 189 279 159 7 332 1 278 1 1 1 1 1 1 7 
7 251 83 27 251 7 1 1 7 2 6 2 2 2 2 7 2 2 2 2 2 2 7 2 2 2 2 2 2 2 6 2 2 501 2 2 2 2 2 4 2 6 2 501 2 2 2 2 4 2 2 6 2 2 2 2 2 4 2 2 501 503 2 7 2 2 2 6 2 2 2 329 2 329 2 2 329 329 2 2 2 2 2 2 2 2 2 2 333 7 114 1 5 502 1 1 498 3 1 7 
7 264 498 1 264 7 1 1 7 2 2 503 501 2 4 7 2 2 2 503 2 2 7 2 2 6 2 2 4 2 2 2 2 2 503 6 2 2 2 2 2 503 2 2 6 2 2 2 2 503 2 2 2 2 2 2 503 2 2 2 2 2 2 7 2 2 2 2 2 335 358 359 359 359 360 2 358 359 359 359 360 335 2 501 2 6 2 503 720 7 118 1 1 1 1 5 502 1 1 7 
7 5 502 1 1 33 1 1 7 2 6 2 2 2 2 7 2 2 499 503 2 6 7 2 503 2 2 501 2 2 2 2 2 2 2 2 2 2 2 2 2 2 2 2 2 2 2 2 2 2 2 2 501 2 2 2 6 2 499 2 2 2 4 7 503 501 4 2 2 337 399 381 381 381 382 2 380 381 381 381 400 339 2 4 2 499 2 2 723 7 332 500 1 498 1 1 1 1 1 7 
7 1 1 1 498 1 3 1 7 2 2 2 2 2 2 7 2 2 2 2 2 2 7 2 2 2 503 2 2 11 250 190 190 190 190 190 266 266 250 176 176 250 42 43 50 51 16 50 51 42 43 250 176 176 250 266 266 190 190 190 190 190 250 10 503 2 2 2 2 337 413 2 2 2 2 2 2 2 2 2 413 2 2 2 2 503 2 2 333 7 114 1 1 11 199 95 27 27 135 7 
7 356 529 352 1 1 1 1 7 331 2 2 2 6 331 7 4 2 2 4 2 4 7 2 2 6 2 2 2 7 265 197 197 197 197 197 279 279 265 189 189 265 2 2 2 2 2 2 2 2 2 265 189 189 265 279 279 197 197 197 197 197 265 7 2 2 2 503 2 2 413 2 2 6 2 501 6 2 2 2 413 339 2 2 6 2 6 2 720 7 118 1 502 7 196 106 1 1 142 7 
7 372 370 368 1 8 1 1 7 2 4 2 2 503 2 7 331 2 503 2 2 331 7 4 2 2 2 6 2 7 2 2 2 2 2 4 2 503 2 2 2 4 2 6 2 2 2 2 2 2 501 2 6 2 2 2 2 6 2 2 2 2 4 7 2 2 2 2 2 337 413 2 2 499 503 2 2 2 2 4 413 2 2 2 2 2 2 2 723 7 332 1 1 33 334 1 392 338 1 7 
7 1 340 1 1 7 1 500 7 2 2 503 2 2 2 7 2 2 2 2 2 2 7 2 2 503 2 2 2 7 2 329 2 329 503 2 499 329 329 2 2 503 2 2 329 2 329 329 329 2 4 2 2 329 2 329 2 503 2 329 2 329 2 7 6 2 2 6 2 337 411 359 359 359 359 359 359 359 359 359 412 339 2 503 2 2 6 2 333 7 1 5 686 687 1 3 393 394 1 7 
7 95 267 112 113 7 1 1 7 2 2 2 2 6 2 7 2 2 6 2 2 2 7 2 2 2 2 2 2 7 2 358 359 360 2 2 2 358 359 360 2 2 2 2 358 359 359 359 360 2 2 2 499 358 359 360 2 2 2 358 359 360 2 7 2 2 2 2 2 335 380 381 381 381 381 381 381 381 381 381 382 335 2 2 499 2 2 2 720 7 1 1 694 695 498 1 403 368 502 7 
7 106 278 116 117 33 5 1 7 2 6 2 499 2 2 7 2 2 2 2 2 2 7 2 503 2 2 2 2 7 2 380 381 382 2 2 2 380 381 382 2 2 6 2 380 381 381 381 382 2 2 2 2 380 381 382 2 2 2 380 381 382 2 7 2 2 503 501 6 2 2 341 2 341 2 2 341 2 341 2 341 2 2 2 2 501 501 2 723 7 3 1 1 8 334 502 1 5 1 7 
7 1 1 502 1 1 1 1 7 2 2 2 2 2 2 7 2 499 2 6 503 4 7 2 6 2 4 503 2 7 2 341 2 341 2 6 2 341 2 341 2 2 2 2 341 2 2 341 341 503 2 2 2 341 2 341 2 4 2 341 2 341 2 7 2 4 2 2 2 2 2 2 2 2 2 503 2 2 2 2 2 2 4 2 2 2 2 2 333 9 134 16 314 21 16 16 314 16 134 10 
7 498 3 1 500 1 1 3 7 331 2 6 503 2 331 7 2 2 2 2 2 2 7 2 2 2 2 2 2 22 2 2 2 2 2 2 2 2 2 2 2 2 4 503 2 2 2 2 2 2 499 2 2 2 2 503 2 2 2 2 2 2 2 19 280 280 280 280 280 280 280 280 280 280 280 280 280 280 280 280 280 280 280 17 2 2 18 16 16 10 142 1 326 1 1 1 326 5 142 7 
7 1 502 1 1 8 1 1 7 2 2 2 2 2 4 7 331 2 2 2 2 331 7 2 2 503 2 2 2 331 2 2 2 503 2 2 2 2 2 2 2 2 2 2 2 2 2 2 2 2 2 2 6 2 2 2 2 2 2 2 2 2 2 331 293 293 293 293 293 293 293 293 293 293 293 293 293 293 293 293 293 293 293 331 2 2 331 2 2 7 1 392 502 3 328 494 502 392 1 7 
7 5 1 330 1 7 502 3 7 2 503 2 2 2 2 7 2 2 2 2 6 2 7 2 6 2 2 501 2 2 2 2 2 2 4 2 2 503 2 2 503 2 2 501 4 2 2 2 503 6 2 501 501 2 2 4 2 2 2 503 2 2 2 4 2 2 2 2 2 2 2 503 2 2 4 2 503 2 2 4 2 499 2 2 503 2 2 4 2 7 1 411 351 351 351 351 351 412 3 7 
7 350 351 352 1 7 1 1 7 2 6 499 2 2 2 7 2 2 4 2 2 2 7 2 2 2 6 2 2 6 2 4 2 2 2 2 2 2 2 2 2 2 2 2 2 2 2 4 2 2 2 4 2 499 2 2 2 2 2 2 501 2 2 2 2 503 501 2 2 4 2 2 2 2 2 2 6 2 2 2 2 2 2 501 2 2 2 2 2 7 502 366 367 367 367 367 367 368 1 7 
7 366 367 368 1 7 498 1 7 2 2 2 503 2 2 7 2 503 2 2 2 2 7 2 6 503 2 2 2 2 2 2 2 2 2 2 6 2 2 2 2 2 503 2 2 2 2 2 2 2 2 2 2 2 503 2 2 2 2 2 2 4 2 2 2 2 2 2 2 2 2 2 2 2 2 2 2 2 2 2 503 2 2 2 2 2 4 2 2 7 1 334 496 1 500 502 1 334 1 7 
7 1 340 1 1 7 3 1 7 2 2 2 2 2 2 7 2 2 2 501 6 2 7 2 2 2 2 11 83 199 199 199 199 199 199 267 27 641 641 641 641 641 641 641 641 641 641 641 641 83 56 57 83 641 641 641 641 641 641 641 641 641 15 134 314 16 34 35 38 39 16 38 39 34 35 16 314 134 12 6 2 2 6 2 6 2 2 2 2 7 1 502 1 3 1 1 1 1 1 7 
9 16 16 16 16 21 16 16 20 331 2 2 499 6 331 7 2 2 2 2 2 2 7 2 2 4 2 7 2 207 207 207 207 207 207 279 335 671 669 669 669 671 671 669 669 669 669 669 669 335 2 2 335 669 669 669 669 669 669 669 669 669 7 142 326 1 1 1 1 1 5 1 1 1 1 1 326 142 7 2 2 499 2 2 2 11 82 34 35 21 16 314 34 35 16 266 17 1 502 7 
7 2 2 501 2 2 2 2 2 2 2 2 2 2 2 7 331 2 6 2 2 331 22 2 2 2 2 7 2 4 2 2 503 2 6 503 2 2 501 4 503 2 499 2 2 503 4 2 501 503 2 2 2 2 499 2 6 2 503 503 2 501 7 1 5 1 496 1 1 3 1 494 1 1 1 1 498 502 7 2 503 2 2 2 2 7 1 328 328 328 328 326 328 328 1 278 1 3 1 7 
7 6 503 2 6 2 2 503 2 4 2 503 6 2 2 7 2 2 2 4 503 2 2 6 2 501 2 7 503 2 2 364 534 360 2 2 2 6 2 2 2 2 6 2 499 2 2 2 2 2 2 6 2 2 2 503 2 2 2 2 499 6 7 502 1 1 328 328 328 1 1 3 328 328 328 1 5 1 7 2 2 2 4 2 2 7 3 1 1 1 1 498 1 1 1 1 502 1 719 7 
7 2 2 2 2 2 2 503 2 499 2 2 2 503 2 7 2 2 2 2 2 2 2 2 2 2 2 7 2 503 2 386 384 382 2 2 2 678 678 678 678 678 678 678 678 678 678 678 678 2 2 2 2 678 678 678 678 678 678 678 678 678 7 1 1 1 350 351 351 351 351 351 351 351 352 1 1 334 22 2 2 2 501 2 2 7 502 328 328 328 328 1 328 328 1 1 1 1 716 7 
7 4 2 499 2 2 2 2 2 2 2 2 2 2 2 9 16 190 190 190 17 2 2 503 4 2 2 7 2 2 2 2 341 2 2 526 527 2 499 2 501 2 2 2 2 2 2 501 2 335 2 2 335 2 6 2 503 2 2 503 2 2 7 1 1 336 399 367 367 367 367 367 367 367 400 1 1 1 688 689 2 2 503 2 2 7 5 1 1 1 1 502 1 1 1 500 3 1 332 7 
9 613 614 16 16 16 16 16 16 16 12 2 6 2 2 7 335 197 197 197 2 2 6 2 2 499 2 7 2 4 2 2 2 2 495 2 2 2 2 2 2 2 2 503 2 2 2 503 4 2 2 2 499 2 2 501 2 2 2 2 501 503 7 5 1 1 413 502 1 1 1 1 498 3 413 1 496 1 696 697 2 2 2 2 2 7 1 328 328 328 328 5 328 328 1 1 1 1 719 7 
7 615 616 333 6 2 333 2 2 6 22 2 2 2 2 7 343 2 2 2 2 499 2 2 2 2 2 7 2 2 503 364 534 360 2 6 2 2 2 2 4 2 2 2 2 503 2 2 499 2 2 2 2 2 2 2 2 503 2 499 2 6 7 1 1 336 413 1 1 5 1 494 1 1 413 338 1 334 8 2 2 501 2 4 503 7 1 1 500 1 1 502 1 1 1 1 502 1 716 7 
7 2 2 2 2 2 2 2 501 503 2 2 2 501 2 7 343 2 2 2 2 2 2 2 2 6 2 7 503 2 2 386 384 382 2 2 2 678 678 678 678 678 678 678 678 678 678 678 678 2 2 2 2 678 678 678 678 678 678 678 678 678 7 498 1 336 413 1 1 1 1 1 1 502 413 338 1 1 7 2 2 2 2 2 2 7 334 494 1 3 334 1 1 520 521 1 1 1 332 7 
7 2 2 6 2 2 2 2 2 2 2 4 503 2 6 9 16 190 190 190 17 503 2 2 2 2 2 7 2 2 2 2 341 2 503 2 335 2 501 2 2 503 2 2 2 2 2 2 501 522 523 2 335 2 6 499 2 2 2 2 2 499 7 1 1 1 413 1 1 1 1 502 5 1 413 1 1 5 7 503 2 2 2 2 2 7 350 351 351 351 352 1 350 530 1 502 1 1 719 7 
9 16 16 16 16 16 17 333 2 2 8 2 2 2 2 7 335 197 197 197 2 2 4 2 2 2 501 7 2 2 2 2 2 2 2 2 2 4 2 2 501 2 499 2 2 503 2 4 2 2 2 2 2 2 2 2 2 2 503 2 4 2 7 1 1 336 390 1 1 5 1 1 1 1 390 338 1 1 7 2 4 2 503 499 2 7 366 367 367 367 368 1 376 377 1 1 1 498 716 7 
7 631 631 631 631 631 631 4 2 2 7 2 2 499 2 7 343 2 2 2 2 2 2 2 503 4 2 7 2 4 2 364 534 360 2 503 2 2 2 503 2 2 2 2 2 2 2 2 2 503 2 503 2 503 2 2 2 2 2 2 2 499 7 494 5 1 340 1 1 1 1 1 1 1 340 1 1 1 7 2 2 2 2 2 2 7 340 1 5 1 340 1 336 413 494 1 5 1 332 7 
7 655 656 654 654 656 657 632 2 2 7 333 2 4 2 7 343 2 2 503 503 2 4 2 2 2 2 7 2 2 2 386 381 382 2 2 2 678 678 678 678 678 678 678 678 678 678 678 678 2 2 2 2 678 678 678 678 678 678 678 678 678 7 334 1 1 1 1 502 1 1 498 1 3 1 1 1 334 7 2 2 2 2 2 2 7 1 1 1 1 1 1 1 413 1 1 502 1 719 7 
7 2 6 2 2 6 2 2 2 4 7 347 2 2 2 19 16 42 43 16 17 2 2 2 499 6 2 7 2 503 2 2 341 2 2 2 335 499 2 2 501 2 2 2 2 2 503 2 501 335 2 526 527 2 499 2 2 6 2 2 2 2 259 281 281 281 251 281 281 281 251 281 281 281 251 27 27 83 10 2 503 503 2 2 2 7 1 496 1 498 3 1 1 413 1 1 3 1 716 7 
7 16 16 16 16 16 17 333 503 6 7 347 2 2 4 331 2 2 2 2 331 2 2 2 2 2 2 7 6 2 2 2 2 2 503 2 2 2 503 2 2 4 2 499 2 6 2 2 2 2 2 503 2 2 2 2 2 2 2 2 2 499 265 293 293 293 265 293 293 293 265 293 293 293 265 2 392 329 7 2 501 2 2 2 2 7 3 1 1 502 1 1 336 390 494 1 1 1 332 7 
7 631 631 631 631 631 631 632 2 2 7 333 2 2 2 2 2 499 2 2 2 4 2 501 4 2 2 7 2 2 503 364 362 360 2 2 499 2 2 2 2 503 2 2 2 2 2 503 503 503 2 4 2 503 2 2 2 2 2 2 4 2 2 2 2 2 503 2 2 6 2 2 2 2 503 6 393 401 7 2 2 2 2 4 2 19 16 16 16 16 16 16 16 17 637 638 18 16 16 7 
7 653 653 657 657 657 655 632 2 2 7 347 2 503 4 501 2 4 2 2 2 503 2 2 2 2 501 7 2 2 503 386 384 382 2 2 2 678 678 678 678 678 678 678 678 678 678 678 678 2 2 2 2 2 2 6 2 503 2 2 2 2 2 4 2 2 2 2 2 503 2 503 2 2 2 2 408 382 22 2 503 4 2 2 2 2 2 2 2 2 2 2 2 2 662 663 2 2 2 7 
7 2 6 2 2 2 4 6 2 6 7 347 2 2 2 2 2 2 2 2 2 2 499 2 2 503 2 7 2 4 2 2 341 2 2 2 335 499 2 501 2 2 499 503 2 503 2 499 2 335 2 2 503 2 2 2 2 2 2 2 4 2 2 2 2 2 2 2 2 2 2 2 499 2 2 2 639 640 690 691 2 2 2 499 2 6 503 4 2 2 2 499 2 2 503 2 6 2 2 7 
9 266 50 51 642 642 642 642 46 47 648 642 642 642 54 55 72 16 16 152 12 2 2 4 2 2 2 7 2 2 495 2 2 503 2 503 2 2 2 6 2 2 2 2 6 2 501 2 2 2 2 6 2 2 2 2 2 6 2 2 2 503 2 2 2 2 503 2 2 4 2 2 2 2 4 2 664 665 698 699 2 2 2 503 2 2 501 2 503 2 2 499 2 2 2 2 2 503 2 7 
7 279 6 2 669 669 669 669 2 503 669 669 669 669 6 2 499 2 503 159 7 2 2 2 2 6 2 7 6 2 2 364 534 360 2 2 4 503 2 2 503 2 2 503 2 2 503 2 2 503 2 2 2 2 2 503 2 2 2 2 2 2 2 2 2 6 2 2 2 2 2 2 503 2 2 2 503 2 8 2 2 2 2 4 2 2 2 2 2 2 2 2 2 2 4 503 2 4 2 7 
7 333 2 2 2 503 2 2 6 2 499 2 2 503 2 503 2 2 503 6 7 2 2 503 2 2 2 7 2 2 2 386 384 382 2 2 2 11 83 251 36 37 251 56 57 79 73 83 56 57 251 44 45 251 56 57 79 48 49 79 56 57 251 44 45 251 56 57 83 73 79 56 57 251 40 41 251 83 14 16 16 16 16 16 16 16 613 614 12 2 2 2 8 335 2 2 2 2 335 7 
7 126 2 2 679 678 680 679 2 2 683 678 682 683 2 2 333 361 360 2 7 2 2 2 2 2 2 7 503 2 2 2 341 2 503 2 503 7 1 264 1 1 264 1 1 502 1 1 336 1 264 1 1 264 502 1 1 1 1 1 1 1 264 1 1 264 1 502 1 1 5 1 1 264 1 1 264 1 7 631 631 631 631 631 631 333 615 616 7 2 4 2 7 2 2 2 6 2 2 7 
7 130 503 2 4 2 2 2 2 501 2 2 2 499 2 2 2 374 388 2 7 2 4 2 4 2 2 19 42 43 266 190 190 72 42 43 190 10 1 502 5 1 498 328 1 496 328 1 5 1 1 494 1 5 1 328 338 502 328 1 5 502 3 1 494 1 328 1 496 328 1 502 1 328 1 1 502 1 7 653 656 656 654 656 655 2 2 4 7 2 2 2 7 2 2 2 2 2 2 7 
7 333 2 2 2 2 2 2 2 503 2 2 4 2 2 499 6 413 339 2 7 2 2 2 2 2 2 4 2 2 279 197 197 2 2 6 197 7 330 1 524 525 414 415 416 417 418 419 420 421 334 1 1 334 430 431 432 433 417 434 435 436 334 1 1 334 414 415 416 417 418 419 420 421 334 1 502 330 7 2 4 2 2 2 2 2 2 2 7 2 499 503 7 2 2 503 2 499 2 7 
7 126 2 2 678 679 680 678 2 2 678 682 683 680 2 2 2 393 401 503 7 2 499 503 2 2 2 499 2 2 2 503 2 2 2 2 2 7 114 1 494 1 444 445 446 447 448 449 450 451 1 1 1 1 453 454 455 456 457 458 459 460 1 1 5 1 444 445 446 447 448 449 450 451 1 1 3 719 7 16 16 16 16 16 17 2 503 6 7 2 2 2 7 2 499 6 2 2 2 7 
7 130 2 2 2 499 2 2 2 6 2 499 2 2 2 503 333 408 382 2 7 2 2 2 2 6 2 2 503 2 4 2 2 499 2 2 4 7 118 502 1 334 462 463 464 465 466 467 468 469 520 521 1 334 478 479 480 481 482 483 484 485 520 521 1 334 462 463 464 465 466 467 468 469 334 1 1 716 7 631 631 631 631 631 631 333 2 2 7 2 4 2 7 2 2 2 4 2 4 7 
7 333 6 2 2 503 2 2 2 2 2 2 2 503 2 2 2 499 2 6 7 2 4 2 2 2 2 2 2 2 2 2 2 2 503 2 2 7 330 1 498 1 1 340 1 496 1 1 1 340 1 1 1 494 1 340 502 1 340 1 340 1 5 1 1 5 1 500 340 1 1 340 1 3 1 1 1 330 7 653 654 656 656 656 655 2 2 2 7 2 2 2 7 2 4 2 2 2 2 7 
9 27 190 190 83 36 37 235 124 125 235 40 41 85 4 2 2 87 267 27 32 52 53 73 27 27 83 73 27 27 12 347 2 2 2 2 349 7 1 1 5 1 1 1 1 336 1 5 498 1 502 1 1 5 1 1 1 1 3 1 1 502 1 1 1 1 1 502 1 340 1 500 1 1 494 1 502 1 7 2 6 2 2 2 2 2 4 2 7 2 2 2 7 2 2 2 2 2 2 7 
7 333 197 197 4 2 6 249 132 133 249 329 2 2 2 2 495 2 279 2 2 2 2 2 2 2 2 2 2 335 7 347 4 2 2 2 349 7 494 1 502 1 1 328 1 1 1 328 328 1 1 1 1 1 502 328 1 328 1 1 336 1 1 5 1 1 1 328 1 3 1 338 1 328 1 1 1 1 7 16 16 16 16 16 17 2 2 2 7 2 2 2 7 2 2 2 503 2 2 7 
7 127 6 503 2 2 2 2 329 2 2 2 4 2 4 2 2 6 2 2 2 339 503 501 2 6 2 6 2 499 7 506 507 2 2 2 333 7 330 3 1 334 430 431 432 433 417 434 435 436 334 1 1 334 414 415 416 417 418 419 420 421 334 1 524 525 430 431 432 433 417 434 435 436 520 521 1 330 7 631 631 631 631 631 631 333 503 2 7 2 2 4 7 2 2 2 2 501 2 7 
7 131 499 2 2 2 337 6 2 2 339 501 2 2 2 2 2 2 503 329 2 495 4 2 329 503 2 2 6 2 7 343 2 503 499 2 345 7 114 496 1 498 453 454 455 456 457 458 459 460 1 1 1 1 444 445 446 447 448 449 450 451 1 1 502 1 453 454 455 456 457 458 459 460 1 1 1 719 7 653 656 656 656 654 655 2 2 2 7 2 499 503 7 2 2 6 2 2 2 7 
7 333 2 526 527 422 423 424 425 426 427 428 429 335 2 2 526 527 437 438 439 440 425 441 442 443 335 2 2 2 7 343 2 2 2 4 345 7 118 1 1 334 478 479 480 481 482 483 484 485 520 521 1 334 462 463 464 465 466 467 468 469 334 1 1 334 478 479 480 481 482 483 484 485 334 1 1 716 7 2 6 2 2 2 2 2 2 2 22 2 2 2 7 2 4 2 4 503 2 7 
7 127 2 2 4 444 445 446 545 546 449 450 452 2 497 2 2 2 461 454 455 456 457 458 553 460 503 2 2 2 7 343 2 2 2 2 345 7 330 1 1 1 1 340 1 1 340 1 502 340 1 1 494 1 340 3 1 1 338 498 1 1 1 1 5 1 340 1 1 340 502 500 340 1 1 3 1 330 7 2 2 2 2 2 503 4 2 2 2 2 2 2 7 2 2 501 2 2 2 7 
7 131 497 2 335 470 471 472 473 474 475 476 477 335 2 2 6 335 486 487 488 489 490 491 492 493 335 6 2 6 7 333 2 2 2 510 511 7 1 1 3 1 502 1 1 3 1 1 1 1 3 1 1 1 1 1 1 340 1 5 502 498 1 502 1 494 1 502 3 1 1 1 3 1 1 1 1 1 7 2 2 4 2 2 2 2 2 2 4 2 2 2 7 2 2 2 2 2 2 7 
7 333 2 2 2 501 341 503 2 337 2 499 341 2 2 4 2 2 337 499 341 495 2 341 499 503 2 2 2 503 7 343 4 499 2 2 345 7 1 1 494 1 1 328 1 336 1 328 1 502 1 1 502 1 1 328 1 1 1 328 1 328 1 1 1 1 328 1 1 336 1 328 1 1 494 1 1 502 9 234 198 198 198 208 234 266 266 34 35 66 38 39 10 2 503 2 2 499 2 7 
7 127 4 2 2 2 2 2 339 2 503 2 2 497 2 2 4 503 2 2 2 2 337 2 4 2 6 2 4 2 7 343 503 2 2 2 345 7 330 1 524 525 414 415 416 417 418 419 420 421 520 521 496 334 430 431 432 433 417 434 435 436 334 1 5 334 414 415 416 417 418 419 420 421 334 1 1 330 7 249 207 207 207 217 249 279 279 2 329 2 329 6 7 2 4 2 2 503 2 7 
7 131 2 2 4 2 329 2 2 2 4 2 329 2 2 2 2 2 2 329 2 4 2 503 329 2 2 2 2 2 7 343 2 2 503 2 345 7 114 502 498 1 444 445 446 447 448 449 450 451 1 1 1 1 453 454 455 456 457 458 459 460 1 1 1 1 444 445 446 447 448 449 450 451 1 1 500 719 7 127 499 6 2 4 2 6 503 4 358 359 360 2 7 2 2 2 2 2 2 7 
7 333 2 2 335 437 438 439 440 425 441 442 443 522 523 2 2 335 422 423 424 425 426 427 428 429 335 2 2 497 7 506 507 2 2 2 333 7 118 1 1 334 462 463 464 465 466 467 468 469 334 1 1 334 478 479 480 481 482 483 484 485 520 521 1 334 462 463 464 465 466 467 468 469 334 1 1 716 7 131 2 2 503 2 2 2 495 2 380 381 382 4 7 2 2 2 2 4 2 7 
7 127 503 2 2 461 454 455 551 552 458 459 460 2 497 2 2 2 444 544 446 447 448 449 450 452 497 2 6 2 7 343 2 4 2 2 345 7 330 1 1 1 1 338 1 496 340 340 1 498 1 5 1 502 1 336 340 1 340 1 1 496 1 1 1 1 340 1 3 1 340 1 340 1 502 1 1 330 7 127 4 2 503 2 4 2 2 2 341 2 341 495 7 503 2 4 2 2 2 7 
7 131 2 526 527 486 487 488 489 490 491 492 493 335 2 2 2 335 470 471 472 473 474 475 476 477 335 2 2 499 7 343 2 2 2 2 345 7 1 5 1 502 1 1 3 1 1 502 1 1 1 635 636 1 1 1 1 498 5 1 1 1 1 502 3 1 1 1 1 494 1 1 502 1 1 3 1 1 7 131 2 6 2 2 2 503 503 6 499 2 2 6 7 335 2 2 2 2 335 7 
7 506 507 2 2 2 341 2 6 2 341 2 341 2 2 2 2 2 341 2 495 2 6 2 501 337 2 2 2 2 7 343 2 2 503 2 345 9 190 190 190 190 250 280 280 280 280 250 266 266 252 660 661 254 266 266 250 280 280 280 280 250 16 42 43 16 42 43 82 15 190 190 190 190 190 176 16 16 20 333 2 499 2 333 18 16 176 190 190 190 190 190 7 126 2 499 2 2 721 7 
7 127 2 6 2 2 2 499 337 2 2 2 2 6 2 2 4 2 2 339 503 337 2 2 329 2 503 2 4 2 7 333 2 2 2 2 333 7 197 197 197 197 265 293 293 293 293 265 279 279 265 2 2 265 279 279 265 293 293 293 293 265 503 2 2 2 2 2 503 7 197 197 197 197 197 189 333 6 2 2 2 2 2 503 2 333 189 197 197 197 197 197 7 130 2 2 501 2 717 7 
7 131 497 2 2 329 2 503 4 503 6 339 501 2 495 2 2 2 2 499 2 329 2 503 2 4 2 2 2 503 7 343 2 499 2 4 345 7 2 2 4 2 2 503 2 503 2 2 6 2 2 503 2 2 4 2 2 503 2 2 2 2 2 2 2 2 4 2 2 7 2 6 503 2 4 2 2 2 2 2 6 2 2 2 2 2 2 6 2 503 2 6 7 335 2 2 503 2 335 7 
7 333 2 2 335 422 423 424 425 426 427 428 429 335 2 2 2 335 437 438 439 440 425 441 442 443 335 497 2 6 7 343 2 503 2 2 345 7 2 2 2 2 2 2 2 2 6 2 2 2 2 4 2 2 2 2 2 2 4 2 2 503 2 2 6 2 2 2 2 7 135 199 199 251 112 113 267 27 12 4 2 2 6 2 11 83 27 209 199 281 281 67 10 126 2 2 2 2 721 7 
7 127 6 503 2 444 544 446 545 546 547 450 452 2 2 2 497 2 461 454 455 456 457 458 459 460 2 499 2 2 7 343 2 2 2 2 345 7 6 2 2 503 2 2 2 2 2 2 503 2 2 2 2 2 2 2 503 2 2 2 2 2 2 2 2 2 2 2 6 7 143 207 207 265 120 121 279 501 7 2 503 2 2 2 7 2 4 217 207 293 293 6 7 130 2 501 2 2 717 7 
7 131 2 2 335 470 471 472 473 474 475 476 477 522 523 2 2 335 486 487 488 489 490 491 492 493 335 2 6 335 7 333 4 2 2 499 333 9 169 315 67 36 37 27 112 113 27 112 113 27 40 41 27 112 113 27 112 113 52 53 27 27 12 522 523 2 503 2 335 7 503 358 363 4 2 503 4 333 22 333 2 2 510 511 22 506 507 503 6 541 360 2 7 335 2 2 4 2 335 7 
7 333 495 2 2 501 341 2 4 329 6 2 341 2 2 6 503 2 2 341 2 2 501 2 341 2 2 2 2 2 7 343 2 2 2 2 345 7 174 326 1 1 1 1 116 117 1 116 117 5 1 1 3 116 117 502 116 117 502 1 350 352 7 2 4 2 2 2 2 7 2 380 379 690 691 2 2 2 2 2 2 6 2 2 2 2 503 690 691 374 388 501 7 126 2 2 2 4 721 7 
7 503 6 2 2 2 2 503 2 2 2 2 499 497 2 2 2 2 6 495 2 337 503 2 2 501 6 4 2 497 7 343 2 2 2 2 345 7 1 5 392 512 513 1 1 502 1 1 1 1 1 1 1 1 1 1 1 1 1 1 366 368 7 4 2 2 2 4 2 7 6 337 391 698 699 2 2 503 2 2 2 2 2 2 2 4 2 698 699 391 339 503 7 130 4 503 2 2 717 7 
9 78 178 637 638 602 16 280 280 66 280 280 66 280 280 190 15 83 73 199 199 112 113 199 199 27 267 12 2 2 7 343 2 503 4 2 345 7 1 1 413 3 1 330 673 676 676 674 672 330 1 498 330 672 674 672 672 673 330 1 328 1 7 2 2 2 2 2 2 7 503 2 335 2 6 501 510 511 8 333 503 2 4 333 8 333 503 2 526 527 2 6 7 335 2 2 2 2 335 7 
7 333 189 662 663 6 333 293 293 331 293 293 331 293 293 197 7 328 392 206 206 116 117 206 206 5 278 7 581 583 7 333 2 2 2 510 511 7 1 336 413 498 1 1 1 1 3 1 1 1 1 502 1 1 1 1 1 500 1 502 350 352 7 522 523 2 503 2 335 9 160 34 35 16 176 16 110 111 21 16 618 581 583 11 32 83 36 37 67 36 37 27 14 135 28 637 638 29 135 10 
7 2 501 2 2 2 503 2 4 2 2 2 2 499 6 331 7 395 396 338 502 1 1 5 500 1 502 263 635 636 7 343 2 503 2 4 720 7 328 1 398 1 1 1 502 1 1 500 1 502 1 1 1 1 1 3 1 498 1 1 366 368 7 503 2 2 2 2 4 7 167 2 2 6 189 335 120 121 335 2 2 2 2 7 5 1 502 1 1 502 1 3 7 142 1 658 659 502 142 7 
7 4 2 503 2 2 2 2 2 2 503 2 4 2 2 345 7 404 405 1 1 1 1 502 1 1 1 264 660 661 7 343 2 2 2 2 723 7 350 351 407 5 1 330 674 672 676 672 673 330 1 1 330 673 672 674 672 674 512 513 502 340 7 2 4 2 2 2 2 7 2 503 2 2 2 2 2 6 2 2 503 526 527 7 1 353 352 633 634 350 530 500 7 342 5 1 1 3 344 7 
7 506 507 2 2 2 333 2 518 519 2 2 2 2 2 345 7 340 1 520 521 5 1 1 1 498 1 1 1 1 7 343 2 2 2 2 333 22 404 367 405 330 1 1 1 1 1 3 1 1 1 1 1 1 1 1 1 1 1 1 350 352 7 2 2 2 2 2 2 7 4 2 2 392 522 523 2 2 2 2 2 2 720 7 1 374 375 658 659 366 379 1 7 342 1 5 498 1 344 7 
9 101 267 253 637 638 255 40 41 12 331 6 2 2 518 519 7 334 494 1 1 1 498 1 1 494 1 5 500 498 7 333 4 2 2 503 2 702 686 687 1 1 1 3 1 1 1 502 1 1 1 498 1 1 1 1 502 1 1 1 366 368 7 335 2 2 2 526 527 7 2 2 329 413 690 691 2 2 2 6 2 6 723 7 1 397 338 1 498 336 413 502 7 342 1 1 1 1 344 7 
7 107 278 264 658 659 264 502 5 7 343 2 2 503 4 345 7 114 1 1 1 528 539 355 1 1 356 529 530 1 7 506 507 499 2 2 2 706 694 695 500 1 1 330 673 674 672 672 672 512 513 1 330 674 672 672 673 676 330 1 1 328 7 2 2 2 2 2 2 7 2 503 402 396 698 699 503 2 2 2 2 2 335 7 1 406 352 1 1 350 407 1 7 342 1 1 5 500 344 7 
7 3 1 328 498 1 328 1 1 7 343 2 2 2 2 345 7 118 5 524 525 369 370 371 334 3 372 370 371 334 7 343 2 2 2 2 333 7 1 498 1 1 502 1 1 1 1 1 1 1 1 1 5 1 1 1 1 1 1 502 350 352 7 2 2 2 4 2 2 7 2 2 409 410 335 2 2 2 2 2 2 503 720 7 1 403 368 633 634 404 405 1 7 334 1 1 502 1 334 7 
7 1 494 350 351 351 352 5 1 7 331 499 2 2 2 331 7 334 502 1 1 502 340 3 1 1 1 340 1 494 7 343 4 2 2 4 720 7 1 1 3 1 1 1 1 1 498 1 3 1 502 1 1 500 1 1 498 1 1 1 366 368 7 2 2 4 2 2 503 7 2 4 2 2 2 2 503 2 2 6 2 503 717 7 1 330 1 658 659 1 330 1 7 1 1 5 1 3 1 7 
7 502 336 399 367 367 400 1 338 7 343 2 6 2 2 2 603 280 280 280 234 280 280 280 234 280 280 280 234 266 621 333 503 2 2 2 723 603 176 280 280 280 234 280 280 280 234 72 54 55 54 55 72 234 280 280 280 234 280 280 280 176 621 522 523 2 2 2 335 603 110 111 234 110 111 234 190 191 637 638 254 42 43 10 1 502 1 1 1 1 1 502 33 334 1 1 1 1 334 7 
7 1 336 413 498 502 413 1 1 7 343 2 2 2 4 2 501 293 293 293 249 293 293 293 249 293 293 293 249 279 2 506 507 2 2 2 333 2 189 293 293 293 249 293 293 293 249 2 2 6 2 2 2 249 293 293 293 249 293 293 293 189 2 2 6 2 2 503 2 499 120 121 249 120 121 249 197 197 662 663 265 2 2 7 500 1 1 3 1 1 1 1 1 502 1 1 498 1 344 7 
7 1 1 390 1 3 390 338 1 7 514 515 2 501 2 2 2 2 2 2 4 2 2 2 2 2 2 2 503 2 4 2 2 2 4 2 2 2 2 4 2 2 2 4 2 2 2 503 2 2 2 2 2 4 2 2 2 2 503 2 2 2 2 499 2 2 2 2 2 2 4 2 2 2 2 2 503 6 2 2 2 4 2 7 1 1 1 1 498 498 1 1 1 1 1 1 1 1 344 7 
7 1 1 340 502 1 340 1 494 7 343 501 2 2 6 2 2 6 503 2 2 2 2 2 2 503 2 2 499 503 2 2 2 2 2 2 2 2 499 2 2 2 2 2 2 2 6 2 2 2 2 499 503 2 2 2 4 2 2 6 2 2 4 2 2 6 503 2 2 6 2 2 2 2 4 2 2 2 2 2 2 2 503 7 3 1 1 5 1 1 502 1 1 500 502 3 1 1 344 7 
7 3 494 1 1 1 1 500 5 7 343 4 2 2 503 2 6 2 2 2 2 2 2 499 2 2 2 2 2 2 2 6 2 2 499 503 2 4 2 2 2 503 2 2 2 2 2 2 2 4 2 2 2 2 2 2 2 2 503 2 2 2 503 2 2 2 2 2 2 503 2 2 2 503 2 2 2 503 6 2 2 4 2 7 1 502 1 1 1 1 1 1 1 1 1 1 1 498 344 7 
23 26 26 26 26 26 26 26 26 25 26 26 26 26 26 26 26 26 26 26 26 26 26 26 26 26 26 26 26 26 26 26 26 26 26 26 26 26 26 26 26 26 26 26 26 26 26 12 2 2 2 2 11 26 26 26 26 26 26 26 26 26 26 26 26 26 26 26 26 26 26 26 26 26 26 26 26 26 26 26 26 26 26 25 26 26 26 26 26 26 26 26 26 26 26 26 26 26 26 24 
