4 4 4 4 4 4 4 4 4 4 4 4 4 4 4 4 4 4 4 4 4 4 4 4 4 4 4 4 4 4 4 4 4 4 4 4 4 4 4 4 4 4 4 4 4 4 4 4 4 4 4 4 4 4 4 4 4 4 4 4 4 4 4 4 4 4 4 4 4 4 4 4 4 4 4 4 4 4 4 4 4 4 4 4 4 4 4 4 4 4 4 4 4 4 4 4 4 4 4 4 
4 21 22 22 22 22 22 25 22 22 22 22 22 22 22 22 25 22 22 22 22 22 22 22 22 22 22 22 25 22 22 22 22 22 22 22 22 22 22 25 22 22 22 22 22 22 22 22 22 22 22 22 22 22 22 22 22 22 22 22 25 22 22 22 22 22 22 22 22 22 22 25 22 22 22 22 22 22 22 22 22 22 22 25 22 22 22 22 22 22 22 22 22 22 25 22 22 22 26 4 
4 19 11 12 12 12 13 28 0 0 0 0 0 0 0 0 28 0 0 0 0 0 0 0 0 0 0 0 28 0 0 0 0 0 0 0 0 0 0 28 0 0 0 0 0 0 0 0 0 0 0 0 0 0 0 0 0 0 0 0 28 0 0 0 0 0 0 0 0 0 0 28 0 0 0 0 0 0 0 0 0 0 0 28 0 0 0 0 0 0 0 0 0 0 28 0 0 0 29 4 
4 19 14 15 16 17 18 0 0 0 0 0 0 0 0 0 0 0 0 0 0 0 0 0 0 0 0 0 0 0 0 0 0 0 0 0 0 0 0 0 0 0 0 0 0 0 0 0 0 0 0 0 0 0 0 0 0 0 0 0 0 0 0 0 0 0 0 0 0 0 0 0 0 0 0 0 0 0 0 0 0 0 0 0 0 0 0 0 0 0 0 0 0 0 0 0 0 0 20 4 
4 19 43 0 0 0 43 0 0 0 0 0 0 0 0 0 0 0 0 0 0 0 0 0 0 0 0 1 0 0 0 0 0 0 0 0 0 0 0 0 0 0 0 0 0 0 0 0 0 0 0 0 0 0 0 0 0 0 0 0 0 0 0 0 0 0 0 0 0 0 0 0 0 0 0 0 0 0 0 0 0 0 0 0 0 1 0 0 0 0 0 0 0 0 0 0 0 0 20 4 
4 19 0 0 0 0 0 0 0 0 0 0 0 0 0 0 0 0 0 0 0 0 0 0 0 0 0 0 0 0 0 0 0 0 0 0 0 0 0 0 0 0 0 0 0 0 0 0 0 0 0 0 0 0 0 0 0 0 0 0 0 0 0 0 0 0 0 0 0 0 0 0 0 0 0 0 0 0 0 0 0 0 0 0 0 0 0 0 0 0 0 0 0 0 0 0 0 0 20 4 
4 19 0 0 0 0 0 0 0 0 0 0 0 0 0 0 0 0 0 1 0 0 0 0 0 0 0 0 0 0 0 0 0 0 0 0 0 0 0 0 0 0 0 0 0 0 0 0 0 0 0 0 0 0 0 0 0 0 0 0 0 1 0 0 0 0 0 0 0 1 0 0 0 0 0 0 0 0 0 0 0 0 0 0 0 0 0 0 0 0 0 0 0 1 0 0 0 0 20 4 
4 19 0 0 0 0 0 0 44 45 45 45 46 0 0 0 0 0 0 0 44 52 53 54 46 0 0 0 0 0 0 0 44 52 53 54 46 0 0 0 0 0 44 45 45 45 46 73 0 0 0 0 74 44 52 53 54 46 0 0 0 0 0 44 45 45 45 46 0 0 0 0 0 0 0 44 45 45 45 46 0 0 0 0 0 0 0 44 52 53 54 46 0 0 0 0 0 0 20 4 
4 19 0 0 0 0 0 0 47 34 35 36 48 0 0 0 0 0 0 0 55 56 57 58 59 0 0 0 0 0 0 0 55 56 57 58 59 0 0 0 0 0 47 34 35 36 48 75 0 0 0 0 74 55 56 57 58 59 0 0 0 0 0 47 34 35 36 48 0 0 0 0 0 0 0 47 34 35 36 48 0 0 0 0 0 0 0 55 56 57 58 59 0 0 0 0 0 0 20 4 
4 19 0 0 0 0 0 0 47 37 38 39 48 0 0 0 0 0 0 0 60 61 62 63 64 0 0 0 0 0 0 0 60 61 62 63 64 0 0 0 0 0 47 37 38 39 48 75 0 0 0 0 74 60 61 62 63 64 0 0 0 0 0 47 37 38 39 48 0 0 0 0 0 0 0 47 37 38 39 48 0 0 0 0 0 0 0 60 61 62 63 64 0 0 0 0 0 0 20 4 
4 19 0 0 0 0 0 0 47 40 41 42 48 0 0 0 0 0 0 0 47 65 66 67 48 0 0 0 0 0 0 0 47 65 66 67 48 0 0 0 0 0 47 40 41 42 48 75 0 0 0 0 74 47 65 66 67 48 0 0 0 0 0 47 40 41 42 48 0 0 0 0 0 0 0 47 40 41 42 48 0 0 0 0 0 0 0 47 65 66 67 48 0 0 0 0 0 0 20 4 
4 19 0 0 0 0 0 0 49 50 50 50 51 0 0 0 0 0 0 0 49 50 68 69 51 0 0 0 0 0 0 0 49 50 68 69 51 0 0 0 0 0 49 50 50 50 51 75 0 1 0 0 74 49 50 68 69 51 0 0 0 0 0 49 50 50 50 51 0 0 0 0 0 0 0 49 50 50 50 51 0 0 0 0 0 0 0 49 50 68 69 51 0 0 0 0 0 0 20 4 
4 19 0 0 0 1 0 0 0 0 0 0 0 0 0 0 0 0 0 0 0 70 71 72 0 0 0 0 0 0 0 0 0 70 71 72 0 0 0 0 0 0 0 0 0 0 0 75 0 0 0 0 76 0 70 71 72 0 0 0 0 0 0 0 0 0 0 0 0 0 0 0 0 0 0 0 0 0 0 0 0 0 0 0 0 0 0 0 70 71 72 0 0 0 0 0 0 0 20 4 
4 19 0 0 0 0 0 0 0 0 0 0 0 0 0 0 0 0 0 0 0 0 0 0 0 0 0 0 0 0 0 0 0 0 0 0 0 0 0 0 0 0 0 0 0 0 0 75 0 0 0 0 76 0 0 0 0 0 0 0 0 1 0 0 0 0 0 0 0 0 0 1 0 0 0 0 0 0 0 0 0 0 0 0 0 0 0 0 0 0 0 0 0 0 1 0 0 0 20 4 
4 19 0 0 0 0 0 0 0 0 0 0 0 0 0 0 0 0 0 0 0 0 0 0 0 0 0 0 0 0 0 0 0 0 0 0 0 0 0 0 0 0 0 0 0 0 0 75 0 0 0 0 76 0 0 0 0 0 0 0 0 0 0 0 0 0 0 0 0 0 0 0 0 0 0 0 0 0 0 0 0 0 0 0 0 0 0 0 0 0 0 0 0 0 0 0 0 0 20 4 
4 19 0 0 0 0 0 0 0 0 0 0 0 0 0 0 0 0 1 0 0 0 0 0 0 0 0 0 0 0 0 1 0 0 0 0 0 0 0 0 0 1 0 0 0 0 0 75 0 0 0 0 76 0 0 0 0 0 0 0 0 0 0 0 0 0 0 0 0 0 0 0 0 0 0 0 0 0 0 0 0 0 0 0 0 0 0 0 0 0 0 0 0 0 0 0 0 0 20 4 
4 19 0 0 0 0 0 0 0 0 0 0 0 0 0 0 0 0 0 0 0 0 0 0 0 0 0 0 0 0 0 0 0 0 0 0 0 0 0 0 0 0 0 0 0 0 0 75 0 0 0 0 76 0 0 0 0 0 0 0 0 0 0 0 0 0 0 0 0 0 0 0 0 0 0 0 0 0 0 0 0 1 0 0 0 0 0 0 0 0 0 0 0 0 0 0 0 0 20 4 
4 19 0 0 0 0 0 0 44 52 53 54 46 0 0 0 0 0 0 0 44 45 45 45 46 0 0 0 0 0 0 0 44 45 45 45 46 0 0 0 0 0 44 45 45 45 46 75 0 1 0 0 76 44 45 45 45 46 0 0 0 0 0 44 52 53 54 46 0 0 0 0 0 0 0 44 52 53 54 46 0 0 0 0 0 0 0 44 45 45 45 46 0 0 0 0 0 0 20 4 
4 19 0 0 0 0 0 0 55 56 57 58 59 0 0 0 0 0 0 0 47 34 35 36 48 0 0 0 0 0 0 0 47 34 35 36 48 0 0 0 0 0 47 34 35 36 48 75 0 0 0 0 76 47 34 35 36 48 0 0 0 0 0 55 56 57 58 59 0 0 0 0 0 0 0 55 56 57 58 59 0 0 0 0 0 0 0 47 34 35 36 48 0 0 1 0 0 0 20 4 
4 19 0 0 0 0 0 0 60 61 62 63 64 0 0 0 0 0 0 0 47 37 38 39 48 0 0 0 0 0 0 0 47 37 38 39 48 0 0 0 0 0 47 37 38 39 48 75 0 0 0 0 76 47 37 38 39 48 0 0 0 0 0 60 61 62 63 64 0 0 0 0 0 0 0 60 61 62 63 64 0 0 0 0 0 0 0 47 37 38 39 48 0 0 0 0 0 0 20 4 
4 19 0 0 0 0 0 0 47 65 66 67 48 0 0 0 0 0 0 0 47 40 41 42 48 0 0 0 0 0 0 0 47 40 41 42 48 0 0 0 0 0 47 40 41 42 48 75 0 0 0 0 76 47 40 41 42 48 0 0 0 0 0 47 65 66 67 48 0 0 0 0 0 0 0 47 65 66 67 48 0 0 0 0 0 0 0 47 40 41 42 48 0 0 0 0 0 0 20 4 
4 19 0 0 0 0 1 0 49 50 68 69 51 0 0 0 0 0 0 0 49 50 50 50 51 0 0 0 0 0 0 0 49 50 50 50 51 0 0 0 0 0 49 50 50 50 51 75 0 0 0 0 76 49 50 50 50 51 0 0 0 0 0 49 50 68 69 51 0 0 0 0 0 0 0 49 50 68 69 51 0 0 0 0 0 0 0 49 50 50 50 51 0 0 0 0 0 0 20 4 
4 19 0 0 0 0 0 0 0 70 71 72 0 0 0 0 0 0 0 0 0 0 0 0 0 0 0 0 0 0 0 0 0 0 0 0 0 0 0 0 0 0 0 0 0 0 0 75 0 1 0 0 76 0 0 0 0 0 0 0 0 0 0 0 70 71 72 0 0 0 0 0 0 0 0 0 70 71 72 0 0 0 0 0 0 0 0 0 0 0 0 0 0 0 0 0 0 0 20 4 
4 19 0 0 0 0 0 0 0 0 0 0 0 0 0 0 0 0 1 0 0 0 0 0 0 0 0 0 0 0 1 0 0 0 0 0 0 0 0 0 0 0 0 0 0 0 0 75 0 0 0 0 76 0 0 0 0 0 0 0 0 0 0 0 0 0 0 0 0 0 0 0 0 0 0 0 0 0 0 0 0 0 0 1 0 0 0 0 0 0 0 0 0 0 0 0 0 0 20 4 
4 19 0 0 0 0 0 0 0 0 0 0 0 0 0 0 0 0 0 0 0 0 0 0 0 0 0 0 0 0 0 0 0 0 0 0 0 0 0 0 0 0 0 0 0 0 0 75 0 0 0 0 74 0 0 0 0 0 0 0 0 0 0 0 0 0 0 0 0 0 0 0 0 0 0 0 0 0 0 0 0 0 0 0 0 0 0 0 0 0 0 0 0 0 0 0 0 0 20 4 
4 19 0 0 0 0 0 0 0 0 0 0 0 0 1 0 0 0 0 0 0 0 0 0 0 0 0 0 0 0 0 0 0 0 0 0 0 0 0 0 0 0 0 0 0 0 0 75 0 0 0 0 76 0 0 0 0 0 0 0 0 0 0 0 0 0 0 0 0 0 0 0 0 0 0 0 0 0 0 0 0 0 0 0 0 0 0 0 0 0 0 0 0 0 0 0 0 0 20 4 
4 19 0 0 0 0 0 0 0 0 0 0 0 0 0 0 0 0 0 0 0 0 0 0 0 0 0 0 0 0 0 0 0 0 0 0 0 0 0 0 0 0 0 0 0 0 0 75 0 0 0 0 76 0 0 0 0 0 0 0 0 0 0 44 52 53 54 46 0 0 0 0 0 0 0 0 0 0 0 0 0 0 0 0 0 0 0 0 0 0 0 0 0 0 0 0 0 0 20 4 
4 19 0 0 1 0 0 0 44 45 45 45 46 0 0 0 0 0 0 0 44 52 53 54 46 0 0 0 0 0 0 0 44 52 53 54 46 0 0 0 0 0 0 0 77 78 78 79 0 0 0 0 80 81 81 82 0 0 0 0 0 0 0 55 56 57 58 59 0 0 0 0 0 0 0 44 45 45 45 46 0 0 0 0 0 0 0 44 52 53 54 46 0 0 0 0 0 0 20 4 
4 19 0 0 0 0 0 0 47 34 35 36 48 0 0 0 0 0 0 0 55 56 57 58 59 0 0 0 0 0 0 0 55 56 57 58 59 1 0 0 0 0 0 0 0 0 0 0 0 0 0 0 0 0 0 0 0 0 0 0 0 0 0 60 61 62 63 64 0 0 0 0 0 0 0 47 34 35 36 48 0 0 0 0 0 0 0 55 56 57 58 59 0 0 0 0 0 0 20 4 
4 19 0 0 0 0 0 0 47 37 38 39 48 0 0 0 0 0 0 0 60 61 62 63 64 0 0 0 0 0 0 0 60 61 62 63 64 0 0 0 0 0 0 0 0 0 0 0 0 0 0 0 0 0 0 0 0 0 0 0 0 0 0 47 65 66 67 48 0 0 0 0 0 0 0 47 37 38 39 48 0 0 0 0 1 0 0 60 61 62 63 64 0 0 0 0 0 0 20 4 
4 19 0 0 0 0 0 0 47 40 41 42 48 0 0 0 0 0 0 0 47 65 66 67 48 0 0 0 0 0 0 0 47 65 66 67 48 0 0 0 0 0 0 0 0 0 0 0 0 0 0 0 0 0 0 0 0 0 0 0 0 0 0 49 50 68 69 51 0 0 0 0 0 0 0 47 40 41 42 48 0 0 0 0 0 0 0 47 65 66 67 48 0 0 0 0 0 0 20 4 
4 19 0 0 0 0 0 0 49 50 50 50 51 0 0 0 0 0 0 0 49 50 68 69 51 0 0 0 0 0 0 0 49 50 68 69 51 0 0 0 0 0 0 0 0 0 0 0 0 0 0 0 0 0 0 0 0 0 0 0 0 0 0 0 70 71 72 0 0 0 0 0 0 0 0 49 50 50 50 51 0 0 0 0 0 0 0 49 50 68 69 51 0 0 0 0 0 0 20 4 
4 19 0 0 0 0 0 0 0 0 0 0 0 0 0 0 0 0 0 0 0 70 71 72 0 0 0 0 0 0 0 0 0 70 71 72 0 0 0 0 0 0 0 0 0 0 0 0 0 0 0 0 0 0 0 0 0 0 0 0 0 0 0 0 0 0 0 0 0 1 0 0 0 0 0 0 0 0 0 0 0 0 0 0 0 0 0 0 70 71 72 0 0 0 0 0 0 0 20 4 
4 19 0 0 0 0 0 0 0 0 0 0 0 0 0 0 0 0 0 0 0 0 0 0 0 0 0 0 0 0 0 0 0 0 0 0 0 0 0 0 0 0 0 0 0 0 0 0 0 0 0 0 0 0 0 0 0 0 0 0 0 0 0 0 0 0 0 0 0 0 0 0 0 0 0 0 0 0 0 0 0 0 0 0 0 0 0 0 0 0 0 0 0 0 0 0 0 0 20 4 
4 19 0 0 0 0 0 0 1 0 0 0 0 0 0 0 0 0 1 0 0 0 0 0 0 0 0 0 0 0 0 0 0 0 0 0 0 0 0 0 0 0 1 0 0 0 0 0 0 0 0 0 0 0 0 0 0 0 0 0 0 0 0 0 0 0 0 0 0 0 0 0 0 0 0 0 0 0 0 0 0 0 0 0 0 0 0 0 0 0 0 0 0 0 0 0 0 0 20 4 
4 19 0 0 0 0 0 0 0 0 0 0 0 0 1 0 0 0 0 0 0 0 0 0 0 0 0 0 0 0 0 0 0 1 0 0 0 0 0 0 0 0 0 0 0 0 0 0 0 0 0 0 0 0 0 0 0 0 0 0 0 0 0 0 0 0 0 0 0 0 0 0 0 0 0 0 0 0 0 0 0 0 0 0 0 0 0 0 0 0 0 0 0 0 0 0 0 0 20 4 
4 19 0 0 0 0 0 0 0 0 0 0 0 0 0 0 0 0 0 0 0 0 0 0 0 0 0 0 0 0 0 0 0 0 0 0 0 0 0 0 0 0 0 0 0 0 0 0 0 0 0 0 1 0 0 0 0 0 0 0 0 0 0 0 0 0 0 0 0 0 0 0 0 0 0 0 0 0 0 0 0 0 0 0 1 0 0 0 0 0 0 0 0 0 0 0 0 0 20 4 
4 19 0 0 0 0 0 0 44 45 45 45 46 0 0 0 0 0 0 0 44 45 45 45 46 0 0 0 0 0 0 0 0 0 0 0 0 0 0 0 0 0 0 0 0 0 0 0 0 0 0 0 0 0 0 0 0 0 0 0 0 0 1 0 0 0 0 0 0 0 0 1 0 0 0 44 52 53 54 46 0 0 0 0 0 0 0 44 52 53 54 46 0 0 0 0 0 0 20 4 
4 19 0 0 0 0 0 0 47 34 35 36 48 0 0 0 0 0 0 0 47 34 35 36 48 0 0 0 0 0 0 0 0 0 0 0 0 0 0 0 0 0 0 0 0 0 0 0 0 0 0 0 0 0 0 0 0 0 0 0 0 0 0 0 0 0 0 0 0 0 0 0 0 0 0 55 56 57 58 59 0 0 0 0 0 0 0 55 56 57 58 59 0 0 0 0 0 0 20 4 
4 19 0 0 0 0 0 0 47 37 38 39 48 0 0 0 0 0 0 0 47 37 38 39 48 0 0 0 0 0 0 0 0 0 0 1 0 0 0 0 0 0 0 0 0 0 0 0 0 0 0 0 0 0 0 0 0 0 0 0 0 0 0 0 0 0 0 0 0 0 0 0 0 0 0 60 61 62 63 64 0 0 0 0 0 0 0 60 61 62 63 64 0 0 0 0 0 0 20 4 
4 19 0 0 0 0 0 0 47 40 41 42 48 0 0 0 0 0 0 0 47 40 41 42 48 0 0 0 0 0 0 0 0 0 0 0 0 0 0 0 44 52 53 54 46 0 0 0 0 0 0 0 0 0 0 44 52 53 54 46 0 0 0 0 0 0 0 0 0 0 0 0 0 0 0 47 65 66 67 48 0 0 0 0 0 0 0 47 65 66 67 48 0 0 0 0 0 0 20 4 
4 19 0 0 0 0 0 0 49 50 50 50 51 0 0 0 0 0 0 0 49 50 50 50 51 0 0 0 0 0 0 0 0 0 0 0 0 0 0 0 55 56 57 58 59 0 0 0 0 0 1 0 0 0 0 55 56 57 58 59 0 0 0 0 0 0 0 0 0 0 0 0 0 0 0 49 50 68 69 51 0 0 0 0 0 0 0 49 50 68 69 51 0 0 0 0 0 0 20 4 
4 19 0 0 0 0 0 0 0 0 0 0 0 0 0 0 0 1 0 0 0 0 0 0 0 0 0 0 0 0 0 0 0 0 0 0 0 0 0 0 60 61 62 63 64 0 0 0 0 0 1 0 1 0 0 60 61 62 63 64 0 0 1 0 0 0 0 0 0 0 0 0 0 0 0 0 70 71 72 0 0 0 0 0 0 0 0 0 70 71 72 0 0 0 0 0 0 0 20 4 
4 19 0 0 0 0 0 0 0 0 0 0 0 0 0 0 0 0 0 0 0 0 0 0 0 0 0 0 0 0 0 0 0 0 0 0 0 0 0 0 47 65 66 67 48 0 0 0 0 0 0 0 0 0 0 47 65 66 67 48 0 0 0 0 0 0 0 0 0 0 0 0 0 0 0 0 0 0 0 0 0 0 0 0 0 0 0 0 0 0 0 0 0 0 0 0 0 0 20 4 
4 19 0 0 0 0 0 0 0 0 0 0 0 0 0 0 0 0 0 0 0 0 0 0 0 0 0 73 0 0 0 0 0 0 0 0 0 0 0 0 49 50 68 69 51 0 0 0 0 0 0 0 0 0 0 49 50 68 69 51 0 0 0 0 0 0 1 0 0 0 0 0 74 0 0 0 0 0 0 0 0 0 0 0 0 0 0 0 0 0 0 0 0 0 0 0 0 0 20 4 
4 19 0 0 0 0 0 0 0 0 0 0 0 0 0 0 0 0 0 0 0 0 0 0 0 0 0 75 0 0 0 0 0 0 0 0 0 0 0 0 0 70 71 72 0 0 0 0 0 0 0 0 0 0 0 0 70 71 72 0 0 0 0 0 0 0 0 0 0 0 0 0 76 0 0 0 0 0 0 0 0 0 0 0 0 0 0 0 0 0 0 0 0 0 0 0 0 0 20 4 
4 19 0 0 0 0 0 0 0 0 0 0 0 0 0 0 0 0 0 0 0 0 0 0 0 0 0 75 0 0 0 0 0 0 0 0 0 0 0 0 0 0 0 0 0 0 0 0 0 0 0 0 1 0 0 0 0 0 0 0 0 0 0 0 0 0 0 0 0 0 0 0 76 0 0 0 0 0 0 0 0 0 0 0 0 0 0 0 0 0 0 0 0 0 0 0 0 0 20 4 
4 19 0 0 0 0 0 0 77 78 78 78 78 78 78 78 78 78 78 78 78 78 78 78 78 78 78 79 0 0 0 0 0 0 0 0 0 0 0 0 0 0 0 0 0 0 0 0 0 208 209 0 0 0 0 0 0 0 0 0 0 0 0 0 0 0 0 0 0 0 0 0 80 81 81 81 81 81 81 81 81 81 81 81 81 81 81 81 81 81 81 82 0 0 0 0 0 0 20 4 
4 19 0 0 0 0 0 0 0 0 0 0 0 0 0 0 0 0 0 0 0 0 0 0 0 0 0 0 0 0 0 0 0 0 1 0 0 0 0 0 1 0 0 0 0 0 0 0 210 211 212 213 0 0 0 0 0 0 0 1 0 0 0 0 0 0 0 0 0 0 0 0 0 0 0 0 0 0 0 0 0 0 0 0 0 0 0 0 0 0 0 0 0 0 0 0 0 0 20 4 
4 19 0 0 1 0 0 0 0 0 0 0 0 0 0 0 0 0 0 0 0 0 0 0 0 0 0 0 0 0 0 0 0 0 0 0 0 0 0 0 0 0 0 0 0 0 0 214 215 216 217 218 219 0 0 0 0 0 0 0 0 0 0 0 0 0 0 0 0 0 0 0 0 0 0 0 1 0 0 0 0 0 0 0 0 0 0 0 0 0 0 0 0 0 0 0 0 0 20 4 
4 19 0 0 0 0 0 0 0 0 0 0 0 0 0 0 0 0 0 0 0 0 1 0 0 0 0 0 0 0 0 0 0 0 0 0 0 0 0 0 0 0 0 0 0 0 0 220 221 222 223 224 225 0 0 0 0 0 0 0 0 0 0 0 0 0 0 0 0 0 0 0 0 0 0 0 1 0 0 0 0 0 0 0 0 0 1 0 0 0 0 0 0 0 1 0 0 0 20 4 
4 19 0 0 0 0 0 0 0 0 0 0 0 0 0 0 0 0 0 0 0 0 0 0 0 0 0 0 0 0 0 0 0 0 0 0 0 0 0 0 0 0 0 0 0 0 0 0 226 227 228 229 0 0 0 0 0 0 0 0 0 0 0 0 0 0 0 0 0 0 0 0 0 0 0 0 0 0 0 0 0 0 0 0 0 0 0 0 0 0 0 0 0 0 0 0 0 0 20 4 
4 19 0 0 0 0 0 0 77 78 78 78 78 78 78 78 78 78 78 78 78 78 78 78 78 78 78 83 0 0 1 0 0 0 0 0 0 0 0 0 0 0 0 0 0 0 0 0 0 230 231 0 0 0 0 0 0 0 0 0 0 0 0 0 0 0 0 0 0 0 0 0 84 81 81 81 81 81 81 81 81 81 81 81 81 81 81 81 81 81 81 82 0 0 0 0 0 0 20 4 
4 19 0 0 0 0 0 0 0 0 0 0 0 0 0 0 0 0 0 0 0 0 0 0 0 0 0 75 0 0 0 0 0 0 0 0 0 0 0 0 0 0 0 0 0 0 0 0 0 0 0 0 0 0 0 0 0 0 0 0 0 0 0 0 0 0 0 0 0 0 0 0 76 0 0 0 0 0 0 0 0 0 0 0 0 0 0 0 0 0 0 0 0 0 0 0 0 0 20 4 
4 19 0 0 0 0 0 0 0 0 0 0 0 0 0 0 0 0 0 0 0 0 0 0 0 0 0 75 0 0 0 0 0 0 0 0 0 0 0 44 52 53 54 46 0 0 0 0 0 0 0 0 0 1 0 0 44 52 53 54 46 0 0 0 0 0 0 0 1 0 0 0 76 0 0 0 0 0 0 0 0 0 0 0 0 0 0 0 0 0 0 0 0 0 0 0 0 0 20 4 
4 19 0 0 0 0 0 1 0 0 0 0 0 0 0 0 0 0 0 0 0 0 0 0 0 0 0 85 0 0 0 0 0 0 0 0 0 1 0 55 56 57 58 59 0 0 0 0 0 0 0 0 0 0 0 0 55 56 57 58 59 0 0 0 0 0 0 0 0 0 0 0 86 0 0 0 0 0 0 0 0 0 0 0 0 0 0 0 0 0 0 0 0 0 0 0 0 0 20 4 
4 19 0 0 0 0 0 0 0 0 0 0 0 0 0 0 0 0 0 0 1 0 0 0 0 0 0 0 0 0 0 0 0 0 0 0 0 0 0 60 61 62 63 64 0 0 0 0 0 0 0 0 0 0 0 0 60 61 62 63 64 0 0 0 0 0 0 0 0 0 0 0 0 0 0 0 0 0 0 0 0 0 0 0 0 0 0 0 0 0 0 0 0 0 1 0 0 0 20 4 
4 19 0 0 0 0 0 0 0 0 0 0 0 0 0 0 0 0 0 0 0 0 0 0 0 0 0 0 0 0 0 0 0 1 0 0 0 0 0 47 65 66 67 48 0 0 0 0 0 0 0 0 0 0 0 0 47 65 66 67 48 0 0 0 0 0 0 0 0 0 0 0 0 0 0 0 0 0 0 0 0 0 0 0 0 0 0 0 0 0 0 0 0 0 0 0 0 0 20 4 
4 19 0 0 0 0 0 0 44 45 45 45 46 0 0 0 0 0 0 0 44 45 45 45 46 0 0 0 0 0 0 0 0 0 0 0 0 0 0 49 50 68 69 51 0 0 0 0 1 0 0 0 0 0 0 0 49 50 68 69 51 0 0 0 0 0 0 0 0 0 0 0 0 0 0 44 45 45 45 46 0 0 0 0 0 0 0 44 45 45 45 46 0 0 0 0 0 0 20 4 
4 19 0 0 0 0 0 0 47 34 35 36 48 0 0 0 0 0 0 0 47 34 35 36 48 0 0 0 0 0 0 0 0 0 0 0 0 0 0 0 70 71 72 0 0 0 0 0 0 0 0 0 0 0 0 0 0 70 71 72 0 0 0 0 0 0 0 0 0 0 0 0 0 0 0 47 34 35 36 48 0 0 0 0 1 0 0 47 34 35 36 48 0 0 0 0 0 0 20 4 
4 19 0 0 0 0 0 0 47 37 38 39 48 0 0 0 0 0 0 0 47 37 38 39 48 0 0 0 0 0 0 0 0 0 0 0 0 0 0 0 0 0 0 0 0 0 0 0 0 0 0 0 0 0 0 1 0 0 0 0 0 0 0 0 0 0 0 0 0 0 0 0 0 0 0 47 37 38 39 48 0 0 0 0 0 0 0 47 37 38 39 48 0 0 0 0 0 0 20 4 
4 19 0 0 0 0 0 0 47 40 41 42 48 0 0 0 0 0 0 0 47 40 41 42 48 0 0 0 0 0 0 0 0 0 0 0 0 0 0 0 0 0 0 0 0 0 0 0 0 0 0 0 0 0 0 0 0 0 0 0 0 0 0 0 1 0 0 0 0 0 0 0 0 0 0 47 40 41 42 48 0 0 0 0 0 0 0 47 40 41 42 48 0 0 0 0 0 0 20 4 
4 19 0 0 0 0 0 0 49 50 50 50 51 0 0 0 0 0 0 0 49 50 50 50 51 0 0 0 0 0 0 0 0 0 0 0 0 0 0 0 0 0 0 0 0 0 0 0 0 0 0 0 0 0 0 0 0 0 0 0 0 0 0 219 0 0 0 0 0 0 0 0 0 0 0 49 50 50 50 51 0 0 0 0 0 0 0 49 50 50 50 51 0 0 0 1 0 0 20 4 
4 19 0 0 0 0 0 0 0 0 0 0 0 0 0 0 0 0 0 0 0 0 0 0 0 0 0 0 0 0 1 0 0 0 0 0 0 0 0 0 0 0 0 0 0 0 0 0 0 0 0 0 0 0 0 0 0 0 0 0 0 0 0 0 0 0 0 0 0 0 0 0 0 0 0 0 0 0 0 0 0 0 1 0 0 0 0 0 0 0 0 0 0 0 0 0 0 0 20 4 
4 19 0 0 0 0 0 0 0 0 0 0 0 0 0 0 0 0 0 0 0 0 0 0 0 0 0 0 0 0 1 0 0 0 0 0 0 0 0 0 0 0 0 0 0 0 0 0 0 0 0 0 0 0 0 0 0 0 0 0 0 0 0 0 0 0 0 0 0 0 0 0 0 0 0 0 0 0 0 0 0 0 0 0 0 0 0 0 0 0 0 0 0 0 0 0 0 0 20 4 
4 19 0 0 0 0 0 0 0 0 0 0 0 0 0 0 0 0 0 0 0 0 0 0 0 0 0 0 0 0 0 0 0 0 0 0 0 0 0 0 0 0 0 0 0 0 0 0 0 0 0 0 0 0 0 0 0 0 0 0 0 0 0 0 0 0 0 0 0 0 0 0 0 0 0 0 0 0 0 0 0 0 0 0 0 0 0 0 0 0 0 0 0 0 0 0 0 0 20 4 
4 19 0 0 0 0 0 0 0 0 0 0 0 0 0 0 0 0 0 0 0 0 0 0 0 0 0 0 0 0 0 0 0 0 0 0 0 0 0 1 0 0 0 0 0 0 0 0 1 0 0 0 0 0 0 0 0 0 0 0 0 0 0 0 0 0 0 0 0 0 0 0 0 0 0 0 0 0 0 0 0 0 0 0 0 0 0 0 0 0 0 0 0 0 0 0 0 0 20 4 
4 19 0 0 0 0 0 0 0 0 0 0 0 0 0 0 1 0 0 0 0 0 0 0 0 0 0 0 0 0 0 0 0 0 0 0 0 0 0 0 0 0 0 0 0 0 0 0 0 0 0 0 0 0 0 0 0 0 0 0 0 0 0 0 0 0 0 0 0 0 0 0 0 0 0 0 0 0 0 0 0 0 0 0 0 0 0 0 0 0 0 0 0 0 0 0 0 0 20 4 
4 19 0 0 0 0 0 0 44 45 45 45 46 0 0 0 0 0 0 0 44 52 53 54 46 0 0 0 0 0 0 0 0 0 0 0 0 0 0 0 0 0 0 0 0 0 0 0 0 0 0 0 0 0 0 0 0 0 0 0 0 0 0 0 0 0 0 0 0 0 0 0 0 0 0 44 52 53 54 46 0 0 0 0 0 0 0 44 45 45 45 46 0 0 0 0 0 0 20 4 
4 19 0 0 0 0 0 0 47 34 35 36 48 0 0 0 0 0 0 0 55 56 57 58 59 0 0 0 0 0 0 0 0 0 0 0 0 0 0 0 0 0 0 0 0 0 0 0 0 0 0 0 0 0 0 0 0 0 0 0 0 0 0 0 0 0 0 0 0 0 0 0 0 0 0 55 56 57 58 59 0 0 0 0 0 0 0 47 34 35 36 48 0 0 0 0 0 0 20 4 
4 19 0 0 0 0 0 0 47 37 38 39 48 0 0 0 0 0 0 0 60 61 62 63 64 0 0 0 0 0 0 0 0 0 0 0 0 0 0 0 0 0 0 0 0 0 0 0 0 0 0 0 0 0 0 0 0 0 0 0 0 0 0 0 0 0 0 0 0 0 0 0 0 0 0 60 61 62 63 48 0 0 0 0 0 0 0 47 37 38 39 48 0 0 0 0 0 0 20 4 
4 19 0 0 0 0 0 0 47 40 41 42 48 0 0 0 0 0 0 0 47 65 66 67 48 0 0 0 0 0 0 0 0 0 0 0 0 0 0 0 0 0 0 0 0 0 0 0 0 0 0 0 0 0 0 0 0 0 0 0 0 0 0 0 0 0 0 0 0 0 0 0 0 0 0 47 65 66 67 48 0 0 0 0 0 0 0 47 40 41 42 48 0 0 0 0 0 0 20 4 
4 19 0 0 0 0 0 0 49 50 50 50 51 0 0 0 0 0 0 0 49 50 68 69 51 0 0 0 0 0 0 0 0 0 0 0 0 0 0 0 0 0 0 0 77 78 78 83 0 0 0 0 84 81 81 82 0 0 0 0 0 0 0 0 0 0 0 0 0 0 0 0 0 0 0 49 50 68 69 51 0 0 0 0 0 0 0 49 50 50 50 51 0 0 0 0 0 0 20 4 
4 19 0 0 0 0 0 0 0 0 0 0 0 0 0 0 0 0 0 0 0 70 71 72 0 0 0 0 0 0 0 0 0 0 0 0 0 0 0 0 0 0 0 0 0 0 0 75 0 0 0 0 76 0 0 0 0 0 0 0 0 0 0 0 0 0 0 0 0 0 0 0 0 0 0 0 70 71 72 0 0 0 0 0 0 0 0 0 0 0 0 0 0 0 0 0 0 0 20 4 
4 19 0 0 0 0 0 0 0 0 0 0 0 0 0 0 0 0 0 0 0 0 0 0 0 0 0 0 0 0 0 0 0 0 0 0 1 0 0 0 0 0 0 0 0 0 0 75 0 0 0 0 76 0 0 0 0 0 0 0 0 0 0 0 0 0 0 0 0 0 0 0 0 0 0 0 0 0 0 0 0 0 0 0 0 0 0 0 0 0 0 0 0 0 0 0 0 0 20 4 
4 19 0 0 1 0 0 0 0 0 0 0 0 0 0 0 0 0 1 0 0 0 0 0 0 0 0 0 0 0 1 0 0 0 0 0 0 0 0 0 0 0 0 0 0 0 0 75 0 0 0 0 76 0 0 0 0 0 0 0 0 0 0 0 0 0 1 0 0 0 0 0 0 0 0 0 0 0 0 0 0 0 0 0 0 0 0 0 0 0 0 0 0 0 0 0 0 0 20 4 
4 19 0 0 0 0 0 0 0 0 0 0 0 0 0 0 0 0 0 0 0 0 0 0 0 0 0 0 0 0 0 0 0 0 0 0 0 0 0 0 0 0 0 0 0 0 0 75 0 0 0 0 76 0 0 0 0 0 0 0 0 0 0 0 0 0 0 0 0 0 0 0 0 0 0 0 0 0 0 0 0 0 0 0 0 0 0 0 0 0 0 0 0 0 0 0 0 0 20 4 
4 19 0 0 0 0 0 0 0 0 0 0 0 0 0 0 0 0 0 0 0 0 0 0 0 0 0 0 0 0 0 0 0 0 0 0 0 0 0 0 0 0 0 0 0 0 0 75 0 1 0 0 76 0 0 0 0 0 0 0 0 0 0 0 0 0 0 0 0 0 0 0 0 0 0 0 0 0 0 0 0 0 0 0 1 0 0 0 0 0 0 0 0 0 0 0 0 0 20 4 
4 19 0 0 0 0 0 0 44 52 53 54 46 0 0 0 0 0 0 0 44 52 53 54 46 0 0 0 0 0 0 0 44 52 53 54 46 0 0 0 0 0 44 45 45 45 46 75 0 0 0 0 76 44 45 45 45 46 0 0 0 0 0 44 45 45 45 46 0 0 0 0 0 0 0 44 52 53 54 46 0 0 0 0 0 0 0 44 52 53 54 46 0 0 0 0 0 0 20 4 
4 19 0 0 0 0 0 0 55 56 57 58 59 0 0 0 0 0 0 0 55 56 57 58 59 0 0 0 0 0 0 0 55 56 57 58 59 0 0 0 0 0 47 34 35 36 48 75 0 0 0 0 76 47 34 35 36 48 0 0 0 0 0 47 34 35 36 48 0 0 0 0 0 1 0 55 56 57 58 59 0 0 0 0 0 0 0 55 56 57 58 59 0 0 0 0 0 0 20 4 
4 19 0 0 0 0 0 0 60 61 62 58 64 0 0 0 0 0 0 0 60 61 62 63 64 0 0 0 0 0 0 0 60 61 62 63 64 0 0 0 0 0 47 37 38 39 48 75 0 0 0 0 76 47 37 38 39 48 0 0 0 0 0 47 37 38 39 48 0 0 0 0 0 0 0 60 61 62 63 48 0 0 0 0 0 0 0 60 61 62 63 48 0 0 0 0 0 0 20 4 
4 19 0 0 0 0 0 0 47 65 66 67 48 0 0 0 0 0 0 0 47 65 66 67 48 0 0 0 0 0 0 0 47 65 66 67 48 0 0 0 0 0 47 40 41 42 48 75 0 0 0 0 76 47 40 41 42 48 0 0 0 0 0 47 40 41 42 48 0 0 0 0 0 0 0 47 65 66 67 48 0 0 0 0 0 0 0 47 65 66 67 48 0 0 0 0 0 0 20 4 
4 19 0 0 0 0 0 0 49 50 68 69 51 0 0 0 0 0 0 0 49 50 68 69 51 0 0 0 0 0 0 0 49 50 68 69 51 0 0 0 0 0 49 50 50 50 51 75 0 0 0 0 76 49 50 50 50 51 0 0 0 0 0 49 50 50 50 51 0 0 0 0 0 0 0 49 50 68 69 51 0 0 0 0 0 0 0 49 50 68 69 51 0 0 0 0 0 0 20 4 
4 19 0 0 0 0 0 0 0 70 71 72 0 0 0 0 0 0 0 0 0 70 71 72 0 0 0 0 0 0 0 0 0 70 71 72 0 0 0 0 0 0 0 0 0 0 0 75 0 0 0 0 76 0 0 0 0 0 0 0 0 0 0 0 0 0 0 0 0 0 0 0 0 0 0 0 70 71 72 0 0 0 0 0 0 0 0 0 70 71 72 0 0 0 0 0 0 0 20 4 
4 19 0 0 0 0 0 0 0 0 0 0 0 0 0 0 0 0 0 0 0 0 0 0 0 0 0 0 0 0 0 0 0 0 0 0 0 0 0 0 0 0 0 0 0 0 0 75 0 0 1 0 76 0 0 0 0 0 0 0 0 0 0 0 0 0 0 0 0 0 0 0 0 0 0 0 0 0 0 0 0 0 0 0 0 0 0 0 0 0 0 0 0 0 0 0 0 0 20 4 
4 19 0 0 0 0 0 0 0 0 0 0 0 0 0 0 0 0 0 0 0 0 0 0 0 0 0 0 1 0 0 0 0 0 0 0 0 0 0 0 0 0 0 0 0 0 0 75 0 0 0 0 76 0 0 0 0 0 0 0 0 0 0 0 0 0 0 0 0 0 0 0 0 0 0 0 0 0 0 0 0 0 0 0 0 0 0 0 0 0 0 0 0 0 0 0 0 0 20 4 
4 19 0 0 0 0 1 0 0 0 0 0 0 0 0 0 0 0 1 0 0 0 0 0 0 0 0 0 0 0 0 0 0 0 0 0 0 0 0 0 0 0 0 0 0 0 0 75 0 0 0 0 76 0 0 0 0 0 0 0 0 0 0 0 0 0 0 0 0 0 1 0 0 0 0 0 0 0 0 0 0 0 0 0 0 0 0 0 0 0 0 0 0 0 0 0 0 0 20 4 
4 19 0 0 0 0 0 0 0 0 0 0 0 0 0 0 0 0 0 0 0 0 0 0 0 0 0 0 0 0 0 0 0 0 0 0 0 0 0 0 0 0 0 0 0 0 0 75 0 0 0 0 76 0 0 0 0 0 0 0 0 0 0 0 0 0 0 0 0 0 0 0 0 0 0 0 0 0 0 0 0 0 0 0 1 0 0 0 0 0 0 0 0 0 0 0 0 0 20 4 
4 19 0 0 0 0 0 0 44 45 45 45 46 0 0 0 1 0 0 0 44 45 45 45 46 0 0 0 0 0 0 0 44 45 45 45 46 0 0 0 0 0 44 52 53 54 46 75 0 0 0 0 76 44 45 45 45 46 0 0 0 0 0 44 52 53 54 46 0 0 0 0 0 0 0 44 45 45 45 46 0 0 0 0 0 0 0 44 52 53 54 46 0 0 0 0 0 0 20 4 
4 19 0 0 0 0 0 0 47 34 35 36 48 0 0 0 0 0 0 0 47 34 35 36 48 0 0 0 0 0 0 0 47 34 35 36 48 0 0 0 0 0 55 56 57 58 59 75 0 0 0 0 76 47 34 35 36 48 0 0 0 0 0 55 56 57 58 59 0 0 0 0 0 0 0 47 34 35 36 48 0 0 0 0 0 0 0 55 56 57 58 59 0 0 0 0 0 0 20 4 
4 19 0 0 0 0 0 0 47 37 38 39 48 0 0 0 0 0 0 0 47 37 38 39 48 0 0 0 0 0 0 0 47 37 38 39 48 0 0 0 0 0 60 61 62 63 64 75 0 0 0 0 76 47 37 38 39 48 0 0 0 0 0 60 61 62 63 64 0 0 0 0 0 0 0 47 37 38 39 48 0 0 0 0 0 0 0 60 61 62 63 64 0 0 0 0 0 0 20 4 
4 19 0 0 0 0 0 0 47 40 41 42 48 0 0 0 0 0 0 0 47 40 41 42 48 0 0 0 0 0 0 0 47 40 41 42 48 0 0 0 0 0 47 65 66 67 48 75 0 0 0 0 76 47 40 41 42 48 0 0 0 0 0 47 65 66 67 48 0 0 0 0 0 0 0 47 40 41 42 48 0 0 0 0 0 0 0 47 65 66 67 48 0 0 0 0 0 0 20 4 
4 19 0 0 0 0 0 0 49 50 50 50 51 0 0 0 0 0 0 0 49 50 50 50 51 0 0 0 0 0 0 0 49 50 50 50 51 0 0 0 0 0 49 50 68 69 51 85 0 0 0 0 86 49 50 50 50 51 0 0 0 0 0 49 50 68 69 51 0 0 0 0 0 0 0 49 50 50 50 51 0 0 0 0 0 0 0 49 50 68 69 51 0 0 0 0 0 0 20 4 
4 19 0 0 0 1 0 0 0 0 0 0 0 0 0 0 0 0 0 0 0 0 0 0 0 0 0 0 0 0 0 0 0 0 0 0 0 0 0 0 0 0 0 70 71 72 0 0 0 0 0 0 0 0 0 0 0 0 0 0 0 0 0 0 70 71 72 0 0 0 0 0 0 0 0 0 0 0 0 0 0 0 0 0 0 0 0 0 70 71 72 0 0 0 0 0 0 0 20 4 
4 19 0 0 0 0 0 0 0 0 0 0 0 0 0 0 0 0 0 1 0 0 0 0 0 0 0 0 0 0 0 0 0 0 1 0 0 0 0 0 0 0 0 0 0 0 0 0 0 0 0 0 1 0 0 0 0 0 0 0 0 0 0 0 0 0 0 0 0 0 0 0 0 0 0 0 0 0 0 0 0 0 1 0 0 0 0 0 0 0 0 0 0 0 0 0 0 0 20 4 
4 19 0 0 0 0 0 0 0 0 0 0 0 0 0 0 0 0 0 0 0 0 0 0 0 0 0 0 0 0 0 0 0 0 0 0 0 0 0 0 0 0 0 0 0 0 0 0 0 0 0 0 0 0 0 0 0 0 0 0 0 0 0 0 0 0 0 0 0 0 0 0 0 0 0 0 0 0 0 0 0 0 0 0 0 0 0 0 0 0 0 0 0 0 0 0 0 0 20 4 
4 19 0 0 0 0 0 0 0 0 0 0 0 0 0 0 0 0 0 0 0 0 0 0 0 0 0 0 0 0 0 0 0 0 0 0 0 0 0 0 0 0 0 0 0 0 0 0 0 0 0 0 0 0 0 0 0 0 0 0 0 0 0 0 0 0 0 0 0 0 0 0 0 0 0 0 0 0 0 0 0 0 0 0 0 0 0 0 0 0 0 0 0 0 0 0 0 0 20 4 
4 5 6 6 6 6 6 6 6 6 6 6 6 6 6 6 6 6 6 6 6 6 6 6 6 6 6 6 6 6 6 6 6 6 6 6 6 6 6 6 6 6 6 6 6 6 6 6 6 6 6 6 6 6 6 6 6 6 6 6 6 6 6 6 6 6 6 6 6 6 6 6 6 6 6 6 6 6 6 6 6 6 6 6 6 6 6 6 6 6 6 6 6 6 6 6 6 6 7 4 
4 8 9 9 9 9 9 9 9 9 9 9 9 9 9 9 9 9 9 9 9 9 9 9 9 9 9 9 9 9 9 9 9 9 9 9 9 9 9 9 9 9 9 9 9 9 9 9 9 9 9 9 9 9 9 9 9 9 9 9 9 9 9 9 9 9 9 9 9 9 9 9 9 9 9 9 9 9 9 9 9 9 9 9 9 9 9 9 9 9 9 9 9 9 9 9 9 9 10 4 
30 31 2 3 9 2 3 9 2 3 9 2 3 9 2 3 9 2 3 9 2 3 9 2 3 9 2 3 9 2 3 9 2 3 9 2 3 9 2 3 9 2 3 9 2 3 9 2 3 9 9 2 3 9 2 3 9 2 3 9 2 3 9 2 3 9 2 3 9 2 3 9 2 3 9 2 3 9 2 3 9 2 3 9 2 3 9 2 3 9 2 3 9 2 3 9 2 3 32 33 
